org_id	org_name
807cit	807-city
aad-2	aad
ablcan-1	abl canada inc.
adcogn	adcognito inc.
aedint	aed internet inc.
amftec	amf technotransport inc.
arwil	ar williams truck equipment
atsaer-1	ats aerospace
bb-50	boing boing
bdws-1	by domain web services
bel-1	bnr europe limited
biomi	biomira inc
bl-169	unmeteredinternet.com
bos-2	basics office supplies
bw-600	big wifi
bwc-64	bells & whistles communications, inc.
bwifn	wapole island first nation
cancom	cancom technologies
canho-2	canhost inc.
capdc	canadian agra project development corp.
ccaat-5	cambrian college of applied arts & technology
cce-129	county of essex
ccg-3	the corporation of the city of gloucester
cdce	commission de cooperation environmentale inc.
cdndq	cablevision du nord de quebec inc
cdndq-1	cablevision du nord de quebec
cds-11	cegep de sainte-foy
cic-2	cuddy international corp.
cidcds	centre informatique des cegeps du saguenay-lac-saint-jean
cigame	cigam entertainment inc.
cihi	canadian institute for health information
cinaxd	cinax designs inc.
cityof-118	city of vancouver
cityof-134	city of kamloops
cjedl	carrefour jeunesse emploi de laval
cl-970	cloudip llc
colleg-13	college shawinigan
colleg-9	college montmorency
com-3	c3 online marketing inc.
comwa-2	comwave telecom inc.
coqb	cogeco communications holdings, inc.
cou	council of ontario universities
cover-13	cover-all computer services corp.
crdhd	capital regional district (health dept.)
cs-2745	cima+ s.e.n.c
csares	csa research
csi-160	commission scolaire des iles
css-11	commission scolaire saint-jean-sur-richelieu
cuug	calgary unix user group
d3man	d3 management
dataso-2	datasoft communications
ddc	doris development canada
ddsma	desjardins ducharmes stein monast avocats
delfo	delfour corp
diditc	did-it.com inc.
dis-10	databridge internet services
djtc	dow jones telerate canada, inc.
dlta	delta cable communications ltd.
dmts-1	dmts
dt-236	datavalet technologies inc.
dvtra	dv trading, llc
ecn-7	ecn
ecns	esc computer network solutions inc.
ecote-1	ecotel inc.
eitc-2	economic innovation and technology council
en-15	2ez network inc.
enmaxe	enmax envision inc.
esct	the elm street computer terminal
ftol	fleetcor technologies operating company, llc
gcl-185-z	g3 canada limited
gdl-10	gage data ltd.
georg-91	georgian.net
glc	greyhound lines of canada
grani-25	granite telecommunications llc
group-72	365 group
gvc-2	global village consulting
hcsa	health and community services agency
hopita-1	hopital montfort
hpl-13	hamilton public library
hrdc-2	human resources development canada
hss-6	harley street software
hydroq-1	hydro-quebec
ib-156	infiniti of bellevue
iboss-8	iboss,inc
ieeeca	ieee canada
ih-165	iqvia holdings inc
iisr	ism canada
iit-1	intera information technologies
info20	info 2000, inc.
infoma-8	infomatch communications inc.
inrste	inrs telecommunications
inter-560	interware net inc.
interp	interprovincial pipeline
isl-1	intransnet service ltd.
isma	information systems management alberta
ismc-2	information systems mgt. corp
itcl-4	itc global
itdntp-495	ip team  do not touch ports
itisi	bravo telecom
jmpeng	jmp engineering inc.
ke-365	krakr enterprises inc
krm	k & r management
labs	labs
lanwo	lanworks inc.
lcl-3	lanhouse communications ltd
leeel	leasding edge electronics (edson) ltd
libert-1	liberty health
liqui-20	liquidnet ltd.
litl	l.e.j. international trucks ltd.
lmwi	last mile wireless internet inc.
lsc-1	locus speech corporation
magell	magellan interactive
magnai-1	magna international inc.
mbpci	mbpci
mcmill	mcmillan bathurst
mdl-50	snagged internet services
memote-1	memotec
mfc-3	mackenzie financial corp
microf-8	microfix computers
milton	milton systems
minerv	minerva technology inc
mnc-381-z	mitel networks corporation
mnsi	managed network systems inc.
moody-z	moody's corp.
msea	mitchell seaforth cable t. v. ltd.
mtic	moonstar technology integration corp
nation-12	national-com internet inc.
nds-2	northern data systems
netce-4	netcelerate corporation
newman	newman consulting
nis-3	novadata information systems inc.
nitid	nitido inc
nl-364	nasn licensing inc.
nl-528	nutrien
norths-7	northstar software
npt-2	nie pc technologies
nstnin	nstn inc.
ntcsof	ntcs of canada
nwici	niagara wireless internet co.
nxcm	nexicom inc.
oic-24	outsource it
onixso	onix solutions
onsite-10	onsite solutions, inc.
opensy-1	opensys inc.
optx20	optx 2000 inc.
oshawa	oshawa foods
ospl-8	ovh singapore pte. ltd
otf	ontario teachers' federation
outloo	outlook systems
parkwo	parkwood hospital
parlee	parlee mclaws
pcn-13	pacific coast net inc.
pds-146	provision data systems inc.
platfo-1	platform computing corporation
pnfi	petawawa national forestry institute
ppla-2	pmg pte. ltd - amanah
presen	presentation edge inc.
pss-10	pinawa secondary school
ptg-49	premier truck group
ptm	public technlogies multimedia
pulson	pulsonic corporation
qe-15	9195-5302 quebec inc. (elpc inc)
qm-11	quickplay media inc
quebe-64	9013-6573 quebec inc.
quebe-67	transat telecom
quebe-77	oxio
rbc-1	royal bank of canada
repasi	repasi computing inc.
rezte	reztel communications inc.
reztek	rez-tek
ridget	ridgetown college
risqr-1	reseau d'informations scientifiques du quebec (risq) inc.
robso-2	robson communications inc
rt-275	radia telecom inc
sasins-1-z	sas institute, inc.
sd3s	school district #36 (surrey)
sfcu-49	ardent credit union
sfgtec-1	sfg technologies inc.
sis-6	strategic information systems
sjsl-1	saint john shipbuilding ltd.
speedw-12	speedware ltee
spindr	spindrift software co.
sprn	sprint
sq-9	surete du quebec
ss-2296	spacex services, inc.
ssc-299	shared services canada
abbott-1	abbott laboratories
acc-13	assiniboine community college
accen-5	accent internet
acmi	air communications international ltd.
acnsa	advanced computer and network solutions (acns)
acr-29	access communications  co-operative limited
adworl	adworld international inc.
ag-42	kaponline
airco-6	aircomplus inc.
alber-67	353233 alberta ltd
anhsr	alberta northwestern health services region
argote	argo-tech productions inc.
atd-17	airfire
atria-3	atria networks lp
b2b2c	b2b2c inc
barobi	b a robinson
bbs42	bbs 42
bcn-21	bell canada - nhs
bcwns	british columbia wireless network society
bellca	bell canada
better-5	better net
biru	beanfield - internal routing use
bistro	bistro internet
blizza-3	blizzard entertainment
bm-1319	brundage management company
bmwcan	bmw canada inc.
bnel	bell nexxia (elgin lab)
brocl	by roxy operations
bt-1259	beauce telecom
bt-431	brama telecom
bullh	bullhosting
campbe-16	campbell communications
cantre	cantrex groupe inc.
cbc-9	crowntek business centers inc.
ccc-818	rbc convention centre winnipeg
ccl-40	cch canadian ltd.
ccp-104	the corporation of the city of pickering
ccp-7	canada computer paper inc.
ccqhs	c.s. centrale quebec/ holland school
ccw-41	county of wellington
cdm-6	college de maisonneuve
cdndt	commission des normes du travail
cdnv	corporation of the district of north vancouver
cdtdq	comm. de transport du quebec
cg-1	cyber generation inc
cg-180	the cantermore group inc
cjl-2	cegep joliette-de lanaudiere
clrd	cariboo library and regional district
cmc-135	children's medical center of dallas
cmd	communications mg direct
cogc	cogent communications
compre-3	compression technologies inc.
connec-12	connect tech, inc.
cpg-1	city of prince george
criti-22	critical media
csb-149	commission scolaire des bois-francs
cscds	centre de services scolaire de la region-de-sherbrooke
csds	commission scolaire de sorel-tracy
cse-4	communications security establishment
ctl-52	cirrus tech ltd.
datac-31	datacenter.bz, llc
datat-5	datatel inc
dcaa	durham college of applied arts and
dccl	dover corporation (canada) limited
dci-4	digital courier international
dcr	denfield communications, reg.
debug	parsehub
dijot	dijoto inc.
disl-4	digitalfyre internet solutions, llc.
dlp-11	d+h limited partnership
domtar-5	domtar inc.
duc	ducks unlimited canada
eagle-28	eagle.ca
eatsl	communicate freely
eds-13	emj data systems
eecsbc	e-comm 911
eisl	enhansen information systems ltd.
elos	elosoft web hosting ltd.
eont	eastern oregon net, inc.
equifa-1	equifax canada inc
ezpro-1	ezprovider networks, inc.
fcl-10	federated co-operatives limited
fionni	fionn industries inc
gdqm	gouvernement du quebec - msss
gill	mcgill university
gmcal	geophysical micro computer applications ltd.
gn-146	ggnet, ggnet.ca
gss-12	glennie stannes strategy
gvtag	translink
hall	harte & lyne limited
harite	haritech consulting
hccl-7	hay communications co-operative limited
hcdsb	halton catholic district school board
helpo	helpox inc
hltn	halton hills hydro
hnl-11	hipaa networks llc
hydras	hydra software
ibuyp	ibuyphonecard.com
icsu	igt canada solutions
igdb	international graphics & designs bc inc.
iis-8	inter-com information services
iisl	inter-com information services ltd.
imc-96	infinite media corp
inc	internet connect inc.
intou-9	24-7 intouch incorporated
intouc	intouch services
iperc-1	iperceptions inc.
ipxon	ipxon
iqi	internet quebec iq inc.
irist-2	iristel
island	island internet inc.
isn-10	ion secured networks inc
iw-1	integral wealth
jumbov	jumbo video inc.
kgsgro	kgs group
kvaern	kvaerner hymac inc.
lacnic	latin american and caribbean ip address regional registry
lakela-1	lakeland college
lancon	lanconnect technology
lesne	les.net
lino	lino solutions internet de télébec
magm	magma communications ltd.
makaer-1	makaera vir inc.
manit-6	swift high speed.com
mcl-3	mcvety company limited
mcs-254	mac's convenience stores inc.
mdmana	md management
metro-2	metrooptic 3cs
mie-17	montreal internet exchange inc.
mk-36	mikmaw kinamatnewey
ml-1315	mxroute llc
msl-136	morneau shepell ltd.
mun	memorial university of newfoundland
netera-2	cybera inc
nl	nebraskalink
nl-108	nate leaver
nnnl	new north networks ltd.
north-507	north nova cable ltd.
nrcfs	natural resources canada - forestry sector
nsl-352	3327783 nova scotia limited
nuvoel	nuvo electronics inc
obn	otterhole bbs non-profit
oceta	ontario centre for environmental technology advancement
ord	orb research and development
org-34822-1	3482286 canada inc
osb-1	okanagan spring brewery
pc-2223	house of commons
peerle	peerless clothing inc.
petcom-1	petcom industries
pmc-6	predictive maintenance corp.
pmt-1	peat marwick thorne
pnap	internap network services corporation
ppdn	p.d.n. product direct network, inc.
ppl-5	poco petroleums ltd.
prca	primus telecommunications canada inc.
price-45	pricemetrix inc.
provi-45	provincial health services authority
psc-21	public service commission
pwcc-1	pratt & whitney canada corp.
q9nt	q9 networks inc.
qc-87	qtrade canada inc
qt-28	qustodio technologies
qtcs	quiet touch computer systems inc.
quanti-2	quantic laboratories
rbl	rice brydone limited
rcc-184	rogers communications canada inc.
rept	reptilian research
retsd	river east transcona school division
revenu	revenue canada
revolv	revolve technologies inc.
rfc-41	resolute fp canada inc.
rns	rogers network services
saskt-2	sasktel cnet
saultc	sault college of applied arts & technology
scbnt	simcoe community broadband network telecommunications inc.
sd8vin-z	school district #85, vancouver island north
sddq	societe d'habitation du quebec
semexc	semex canada
sfus	simon fraser university - surrey
shiftm	shift magazine, inc.
shs-10	selwyn house school
siber-2	sibername.com
sipi-2	debian project
sis-10	skyenet internet solutions
sjhc-3	st joseph's health centre
sl-892	stackpath, llc.
softco	softcop international, inc.
softse	softset consulting
softv-2	softvoyage inc
spmc-1-z	government of saskatchewan
ssc-44	sunset system consulting
ssi-136	8ssi
ssll-1	sourceworks software labs ltd
st-1003	simconet technologies inc.
stcc-4-z	ss&c technologies canada corp.
stg-8	solect technology group inc.
sul-8	sohonet inc.
sw-272	smilegate west, inc.
symbol	symbolics canada, inc.
symtre	symtrex inc.
tcwc	tri city wifi corp.
telus-3	telus mobility
tfl	timberwest forest limited
thenor-2	the north west company
thepra	the praxium group inc.
tk-26	kecommerce
toolsy	tool syndicate
toxikt	toxik technologies inc
transc-2	transcandada pipelines
trs-43	tacoma rubber stamp
tstc-10	swift technology
tt-880	taiga telecom inc.
ttmf	triumf (tri-university meson facility)
twu-1	trinity western university
ubcm	union of british columbia municipalities
urbani	urban insight, inc.
usc-2	unity software (canada) inc.
vfl-63	valley fiber ltd.
virl	vancouver island regional library
virtua-2	virtual prototypes inc.
virtua-35	virtual prototypes inc.
vw-82	velox wireless inc.
washin-5	washington corporations
wcrdn3	wolf creek public schools
webcou	web country
wel-3	wrc enterprises ltd
wfml	west fraser mills ltd.
witl	world infobahn technologies ltd.
wlu-1	wilfrid laurier university
wtbtsc	watch tower bible and tract society of canada
yardi-1	yardi systems, inc.
zcc	zenox communications corporation
sshrc	social science and humanities research council
ssisol	ssi solutions
starga	stargate connections
stc-7	stalworth technologies corp.
stsb	state street bank and trust company
ta-143	tatacommunications america inc
tatac-34	tata communications ltd
tce-2	telnet canada enterprises
tegh	toronto east health network
tff	town of fort frances
thearc-1	the arctic group inc.
thegem	the gemini group
trans-259	transera communications, inc.
tse	tsx inc.
tssl-36	total server solutions llc
tu-129	tesonet, uab
ucc-10	university college of the cariboo
univer-212	universal internet
usse	united software service enterprises
vanro	van-rob stampings inc
vbs	victor beitner services
vc-816	vds corp.
vcl-25	vdz consulting ltd
vdl-3	video dery ltee
vsb-1	vancouver school board
wdfn	whitecap dakota first nation
westar	westar
whatb	whatbox inc.
wt-24	wyzdom technologies
4alolis	421554 alberta ltd.  o/a lethbridge internet s
4cimu	4045599 canada inc (managed uptime)
acnco	acn
acs-19	anpis - computer solutions
agilen-2	agilent technologies
al-3013	abtex llc
alroma	alroma scientifique inc.
applep	applepete's inc.
applic	application enhancements
apss	alberta public safety services
asgrow	asgrow canada
atl-2	axiom technologies ltd.
attach	attachmate canada, inc.
auc-11	algoma university college
autod-3	autodata solutions company
awixso	awix software
barewa	barewall.com inc.
bcb	b.c.telephone co. (bctel)
bcce	the banff centre for continuing education
bcsa-4	british columbia safety authority
bdbc-6	business development bank of canada
bdic	bearing distributors international canada inc
blcl-1	beaver lumber company limited
bnfd	beanfield technologies inc.
canad-73	origen
canada	canadair
cc-1592	crystal connections
cdijft	cdijft
cdl-6	college de l'outaouais
cea	canadian electricity association
cfc-2	clouston foods canada
cffs	canadian forces fleet school
chro	choreo systems inc.
ci-1153	aeonex
cibc	canadian imperial bank of commerce
cic-12	columbia international college
cidddl	centre international des droits de la
clockw	clockworx inc.
cnas	cosmos network access & service
cnf	canadian nature federation
cob	capital offence bbs
colleg-17	college delta
commi-2-z	commission scolaire marguerite-bourgeoys
conso-8	consolidated communications, inc.
convi-2	convio, inc.
copr	cooperative de cablodistribution de l'arriere-pays
cpc-3	cd publishing corporation
cronus	cfactor works inc
cso	commission scolaire outaouais-hull
csp-52	centre de services scolaire de la pointe-de-l'ile
cticor	cti corintech inc.
ctt-16	computer talk
cubexl	cubex ltd
cwc-75	city wide communications inc.
cwt	canusa web trading company
cyberc-2	cyberconcept inc.
cybere-9	cyberedit.com
cybert-2	cybertourisme inc.
dcc-138	metaswitch networks corp.
dge-10	elections quebec
dgl-29	dialoga group llc
disl4	dosarrest internet security ltd
dlsc-1	de la salle college
dp-51	dxmx/direct partnership
dprcs	dufferin-peel catholic district school board
dreo-2	defense research establishment ottawa
dsl-5	domus software ltd.
dtl-36	dash tours ltd
easyd-2	easydns technologies, inc.
edc-1	earth day canada
ei-537	ev1 internet
eidcl	epi internet direct of canada ltd.
empres-2	empress software, inc.
enviro-13	environment canada
epbc	eastern pentecostal bible college
esc-6	envision software consultants inc.
esense	e-sense communications inc.
essl-2	elsid software systems ltd.
ewc-56	eastern wireless .ca inc
ezonem	e-zonemedia
fairvi	fairview college
fbl	francois beauregard logiciels inc.
fcl-211	federated cooperatives limited
fgil	fort garry industries ltd
fgl-3	forzani group limited
fm-406	fastel media inc
fordq-1	federal office of regional development of quebec
formal	formal systems inc.
gcc-120	gridway computing corporation
gcl-61	evolveip, llc
gemcom	gemcom services inc.
gfsl-6	clearddos technologies
gwdgl	go web direct group ltd.
gwncon	gwn consultants
hamil-25	hamilton tigercats
health-11	healthware technologies inc.
hmrinc	hmr inc.
homeco-1	@home.com
htl-33	h4y technologies llc
hwntl	hr wireless netware technology ltd
icc-11	internet canada corp.
illus-1	illustrate inc
ingram	ingram micro inc.
inkset	inksetter & associates
inline	inline communications inc.
jc-114	juce communications inc
jga-17	jonah group/345 adeilaid
jri	james richardson international limited
kot	keyword office technologies
lante-2	lantern hill it inc.
lanter	lanternette inc
lcl-263	lambton communications limited
lesse	metrooptic, inc.
libeo	libeo inc.
liqui-22	liquidnet ltd.
liqui-38	liquidnet us llc
living	livingston group inc.
logici-1	logic innovations
logx	logix communications, inc.
majend	majendie securities
maski-3	maskicom
mbs-2	multipath business systems
mca-161	municipality of the county of annapolis
mcsc	mission community skills centre
mcsne	mcsnet
mcu-1	ministry of colleges and universities
mgn-13	maxx global networks inc.
midwe-147	midwest telecom of america inc
miel-1	midwest internet exchange llc
mil-9	macdon industries ltd.
mitrai	mitra imaging inc.
ms-1565	martin selig
msc-231	moneris solutions corporation
mtrl	metropolitan toronto reference library
nac-178	nokia of america corporation
nation-15	national computers
ndp-1	new democratic party
netlin-3	netlink communications
netsal-2	net sales
netwe-1	netwerx
netwo-240	network innovations inc
netwo-417	412 networks inc
nexust	nexus technologies inc.
nhs-28	niagara health system
nis-121	nolimits internet solutions
nomads	nomad s.e.n.c
novali	novalink
novape	nova petrochemicals inc.
nps-119	nbs payment solutions inc.
nrionl	nri on-line inc.
nspg	nova scotia provincial government
nybe	north york board of education
oceanr	oceanroutes canada, inc.
ocs-119	oncore cloud services
octrf	ontario cancer treatment and research foundation
oeg-2	olympia engineering group inc
ofl-11	o-net
oggo	osi group global offices
ontar-35	datablocks, inc
ontar-44	1923327 ontario inc
ori-14	oak ridges internet inc.
otsl-12	oxygen technical services ltd
pacps	prince albert comprehensive and public schools
pcc-16	proxy communications corporation
pcg-4	paradigm consulting group inc
pelmor	pelmorex communications incorporated
pi-985	pratt institute
pizzol	pizzolato enterprises
planix	planix, inc.
pnsi	pnt systems inc
puctc	cochrane telecom services
pureen	pure energy
pvs-20	pacific value services inc
qqs	qsys quality systems
qsl	qbyte services ltd
quadr-42	xlitt
rcc-190	rogers communications canada inc.
regan-1	regan grant
rfnowi	rf now inc.
rms-1	richter management services inc.
sagh	the salvation army grace hospital -
salvat	salvation army
scc-4	supreme court of canada
4webc	4web.ca
9o9oco	9o9o.com
ac-351	altus communications inc.
acaat	algonquin college of applied arts & technology
accen-66	accentus inc.
acl-82	airstream communications, llc
ais-194	abm integrated solutions
albert-7	alberta supernet incorporated
amd	advanced micro devices, inc.
aovtec	aov technologies
as-2506	advicent solutions
asc-12	archimedes systems consulting, inc.
asc-37	adminstrative support center
asl-256	altima telecom
atu-3	avago technologies u.s. inc.
bc-250	bell canada
bcg-2	blake, cassels and grayden
bcqwhis	bell canada quebec wireless home internet service
bes-35	burlington electrcity services inc.
bnlas	bennett, nidata, legare & associates solutions
bns-34	b2 net solutions inc.
bns-34	b2 net solutions inc.
bns-71	b2 net solutions inc.
bns-71	b2 net solutions inc.
brfn	brant freenet
bridge-10	bridgeway corporation
bwsl	beame and whiteside software ltd.
callpr	callpro canada inc.
cb-1273	city of bathurst
ccc-25	convoke communications corp.
ccl-42	cch canadian ltd.
ccs-47	crestline computer solutions inc.
ccs-8	cyberlink computing services
cdcec	centre d'etudes collegiales en charlevoix
cds-26	cegep de saint-laurent
cecl	conwest exploration company ltd.
cfl-176	cvecfiber
cgacan	cga canada
cgbc-1	centra gas british columbia inc.
cineti	cinetic systems
cita	canadian institute for theoretical astrophysics
cityof-39	city of richmond
cityof-50	city of winnipeg
claim-15	claimspro inc
cli	confederation life ins. co.
cma	canadian medical association
coastn	coastnet designs
commun-3	community access, inc.
corelc	corel corporation
crcl-1	the canned reality company ltd.
crd-43	charles river development
crownl	crown life
csc-167	cyberlink systems corp.
csdc-29	canadian shield data center inc
csm-38	commission scolaire marie-victorin
cvdn	cable vdn inc.
cyberl-5	cyberlink online
databo-1	databoss inc
deesco	dees communication
desir-1	desire2learn incorporated
distri	city of coquitlam
dkal	d.h. kumka & associates ltd.
dofasc	dofasco inc.
dowjon-7	dow jones & company, inc.
dpl-144	dendreon pharmaceuticals llc
dtc-7	deloitte & touche, canada
dtieti	dissident technologies integrateur en telecom incorporee
dwv	district of west vancouver
ec-6	edge creative
ecardi	ecard, inc.
ecia	emily carr institute of art and design
eda-9	electricity distributors association
elc	the equitable life insurance company of canada
elu-2	ex libris (usa) inc
esl-1	enterprise solutions limited
fcl-3	faxon canada, ltd.
fdlvdq	federation de la volaille du quebec
ffca	foundation future charter acad
figmen-1	figment technologies
frhi	fairmont raffles hotels international
gmdh	government of manitoba
gocod	gocodeit inc
goy	government of yukon
graybe	gray beverage inc.
gtcsl	general techniques computer systems limited
gtninc	gtn incorporated
hdcei	hdce inc
hfl-2	hostess frito lay
hgjs	hopital general juif smbd
hie-86	atlantic ixps inc.
his-6	helios integrated systems
hns	hughes network systems
hostz-2	hostzone
ht-185	hockey tech
httl-1	hua tian technology co. ltd.
hvh-9	hudson valley host
hyprot	hyprotech ltd
iasl	internet access solutions ltd.
iddm-1	institut de design montreal
ihtc-4	indiana hemophilia and thrombosis center
imic-1	ingram micro inc. (canada)
ineti	inet-interactif inc
infoli-2	info life inc.
intb1	canadata network
intern-15	internet management inc.
intern-37	internet online
inters-10	interstore communications
isil	inly systems international ltd.
itc-14	information technologies of calgary
itl-2	infoserve technology ltd.
jainv	jainv2
jcs-1	jones computer supplies
jewels	jewelstone systems inc.
jot	job oriented training
jrml-1	j.h. ryder machinery limited
jwh-4	wxhosting.com
kihs	kvnet inc - home satellite
kjmand	kjm and associates
kn-5	kontego networks
ksp-1	kelman seismic processing inc.
ktnk	keewaytinook okimakanak
lancee	lance electronics
lca-4	les consultants androide
lcf	fujilink inc.
lgh	lions gate hospital
ll-912	lounsbury company limited
lmtz	les maitres typographes zibra
louvic	louvicourt mine
lr-130	lion resources, inc
marwa	marwan sultan
mc-790	microsoft corporation
mcs-15	motor city software
mds-168	my digital shield, inc.
media-164	mediaplanet
metro-38	metro optic
mfl-2	mccain foods ltd
micro-231	microtec
microc-11	micro centra
mntn	mountain cablevision ltd.
mplcom	mpl communications inc.
muxlab	mux lab inc.
nbc-1	national bank of canada
nc-1185	nerivon
netlin-13	netline 2000
netopi	netopia corporation
netron	netron inc.
nfbc-1	national film board of canada
nil-13	nygard international ltd.
nits	naviss information technology services
nlg-4	nisgaa lisims goverment
nrbnl	niagara regional broadband networks limited
occ-303	online commerce corp
oi-194	oricom internet inc.
okanag-1	okanagan college
ol-378	oc1-cirrus llc
omegan	omega network co.
ontar-18	huntington travel
ora-5	olson research associates
ordina	ordinateurs pmc inc.
orilli	orillia pronet inc.
otmh	oakville trafalgar memorial hospital
pan-22	palo alto networks, inc
petroc	petro-canada
pgnb	provincial government of new brunswick
pgs	peregrine graphics systems
pgwl	paterson, grant & watson, ltd.
pmc-89	pointpub media communications inc.
powerl-5	powerland
pts-4	professional team solutions inc.
pureb-2	purebackend inc
qcc-18	qwest communications company, llc
qlug	quebec's linux users group
quest-51	questrade inc.
rajen	rajendrasingh
rassel	rasselas
rccllc	royal caribbean cruises ltd.
rdmcor	rdm corporation
redib	redi-bag inc
rihsc-1	the hospital for sick children
rubic-3	rubicon holdings inc
sanyoc	sanyo canada inc.
saq-1	societe des alcools du quebec
scc-21	sentex communications corporation
scg-3	sanders consulting group inc.
shanac	shana corporation
1ccc	1990 cybernet communications corporation
abcn	atlantic business connections network
abs-17	alan barclay systems
access-10	access 20/20 inc.
adc-96	ace data centers, inc.
admsi-1	cfbtel
aeminc	a.e.m. inc.
ai-64	a.r.c. informatique inc.
alber-53	1281103 alberta inc.
aliasr-1	alias research inc.
alnico	alnicom consulting co.
amazo	amazon.com
at-9060	atrema technologies inc.
at-9063	adrem technologies
bal	borstad associates ltd.
ballco	ball corporation
bbswi	bbs wireless inc.
bcc-129	baudry cybernomics corp.
bchs-9	bodwell college & high school
bctl	vancouver brokerage community
beanf-3	beanfield technologies inc.
bicedo	bicedo
bigma-1	business information group
btcl-6	brooke telecom cooperative limited
btl-246	box technology llc
buterf	buterfield and robinson
bzinc	bz inc
cameos-z	cameo systems, inc.
camosu-z	camosun college
canad-103	reis information systems
cantax	cantax
canwel	canwel
cc-1177	crawford & company (canada) inc.
cc-711	cv. cybernet
cdmsc	chris danielle micro solutions (cdms) inc.
cds-4	canbook distr. services
ceryx	ceryx, inc.
choice-20	choice 2000
ciul	cnr international (u.k.) limited
cloud14	cloudflare, inc.
cmc-33	canadian museum of civilization
cmdq	club macintosh de quebec inc.
cn-348	ccl networks inc
colleg-3	college lasalle
comsc-20	comscore, inc.
comsty	comstyle associates
cosl-3	continium online services ltd.
cp-1477	the computer place
cpcl	clover point cartographics ltd.
crclc	champlain regionnal college, lennoxville campus
crypt-2	cryptocybernetics
cryst-3	crystal consulting inc.
csdh-1	commission scolaire des hauts-cantons
cts-379	converging technology solutions inc.
cul-1	canadian utilities ltd.
cws-87	casting workbook services inc.
cybers-26	cyberstream inc.
dcb-59	digital commerce bank
dcl-595	dawson construction ltd.
ddl-1	digital design ltee
desig-54	design print outlet
domtar	domtar packaging
dsu-8	doxim
dtb	dominion toronto bank
dva-5	department of veterans affairs
edrodd	ed rodda
efundr-1	e-fundraising.com
emec	empire media et communications
emsinc	ems inc.
ess-20	enterprise systems solutions inc
etl-74	emerge technologies llc.
europ-8	european meats
evolu-7	evolucionperu
ewr-4	platanum
exper-60	experiencepoint inc
facl	fifth avenue collection ltd.
fc-324	fnf canada
fh-236	flatiron health, inc
fondsf-1	fonds fcar
fts-175	0footprint tech services inc
gmc-149	grant macewan university
googl-2	google llc
gover-15	government of newfoundland and labrador, office of the chief information officer
govern-1	government of manitoba
gp-377	groupe precicom inc.
gprc	grande prairie regional college
gwc	gate west communications
hbc-159-z	hsbc bank canada
hcc-13	hookup communications corp.
healt-217	healthpoint
helixi	helix internet
himl	husky injection molding systems ltd.
hipcom	hip communications
hoppe-1	hopper inc.
hs-215	halogen software inc
iad-1	international academy of design
icc-9	iatronet communications corporation
icl-5	imc canada limited
icl-7	intergraph canada ltd
icp	itech computer products
ilsl	intertrans logistivs solutions limited
incont	incontext corporation
intera-13	interactivity inc.
intera-33	interautomation incorporated
interc-14	inter-cable internet inc.
iti-9	information technology integration
its-30	ikon technology services
iwre	interware.net inc.
johnbu-2	john buhler, inc.
js-505	joust security inc.
jvcc	jeff voskamp (computer consultant)
kd	kw datacenter
keyano-2	keyano college
kmh-8	karl morin holdings inc.
knc-7	ktunaxa nation council
lbmf-1	long beach model forests
lcc-9	lethbridge community college
lcjdm	les centres jeunesse de montreal
ldl-13	london drugs limited
liqui-23	liquidnet ltd.
lmg-2	loyalty management group, inc.
lrcm	lightrealm communications
mascm	manitoba agricultural services corporation (masc)
matane	matane college
mcc-118	microsolve computer capital
mcc-215	microage computer centres
mcg-13	metronet communications group inc.
miahs-1	the michener institute for applied health sciences
micfo-2	micfo, llc.
micfo-2	micfo, llc.
mnc-345	mitel networks cloudlink
mondev	monde virtuel inc.
mrc-12	mount royal university
mwcl	micro warehouse canada ltd.
netdir-1	netdirect, inc.
networ-100	network connection
newage	newage electronics
nic-61	nightingale informatix corporation
novav-3	ip4b inc.
nwst	northwestel inc.
ocu-18	orix corporation usa
ol-159	integrated ls3 solutions
ontar-58	synapse data solutions
orano	orion
orcsw	orcs web, inc.
otn-7	ontario telemedicine network
pdsb-1	peel district school board
pellet	pelletier electronics
phc-32	providence health care
pie-1	pacific interconnect enterprises inc.
pjml	parsa janbeglou media ltd.
pncc-3	palau national communications corporation
ponlix	ponlix group
postm2	postmedia network inc
praxai-2	praxair canada inc.
quebe-52	elpc
quick-11	quickpacket, llc
rbc-4	reality bytes cafe
realmc	realm communications, inc.
ryanas	ryan associates
sacs-8	sfu academic computing services
sagnet	sagnet consulting
sc-9	stafford communications, inc.
sd-24	steelworkers dental
sdn5bv	school district no. 54 (bulkley valley)
sedsys	sed systems incorporated
sfgtec	sfg technologies inc.
sgl-88	servidores grupoweb ltda
sickba	sickbay
sidsd	sandwell inc., datap systems division
sil-5	sogi informatique ltee
snci	stormcloud network (canada) incorprated
softc-7	softchoice
softwa-24	software
solito	soliton associates
sos-3	rms information systems consulting
spheri-8	spherion corporation
spl-7	scarborough public library
sqau	softquad, inc.
sr-627	matbrancher
ss-1547	serverhub seattle
ssc-299-z	shared services canada
stormn	stormnet
suite	suiteworks
sumnet	sumnet, llc
sunli-1	sunlife assurance company of canada
shorel	shoreline communications, inc.
silici	silicium comminications inc.
sjhhc	st. joseph's hospital & health centre
slcl-21	slave lake communications ltd.
slrimsh	the samuel lunenfeld research institute of mount sinai hospital
smitha-1	smith and nephew inc,
spl-9	saskatchewan provincial library
spmc-1	government of saskatchewan
ssrcsb	sudbury separate roman catholic school board
st-542	sergent telecom inc
starbe	starber international inc.
stnx	systronix
sunwi	sunwire inc.
swtc-1	winnipeg technical college
tatac-4	tata communications ltd
telca	telcan inc.
terid-2	teridion inc
thecit-7	the citadel assurance co.
theco-104	the corporation of the city of kawartha lakes
theide	the idea works
thetr-31	the travel corporation (canada) ltd.
tip-10	tetnet internet promotions inc.
trans-126	transvision reseau inc.
tru-6-z	thompson rivers university
tssl-19	total server solutions l.l.c.
tucow	tucows.com co.
ud	utherverse digital inc.
univer-165	university of winnipeg
univer-170-z	university of calgary
univer-33	university of saskatchewan
uos	uniquest on-line services
uwo-z	university of western ontario
vfa	victoria freenet association
viane-3	vianettv inc
videom	videoman systems
viglo-1	viglob informatique
virtua-3	virtual prototypes inc.
viste	vistek
vm-67	von maur inc.
vm6in	vm6 inc.
westbu-2	westburne electric
wight	wightman telecom
wis-123	work it solutions, inc.
wl-113	web2objects llc
zsb-1	zoic studios bc
scl-20	supercom of california limited
sdn7n	school district no. 7 (nelson)
sfxu	st. francis xavier university
sinl	services informatiques netadmin ltee
skyyt	skyytel inc.
slc-4	st. lawrence cement
smu	st mary's university
sns	superior network software
spdne	1651884 ontario inc.
ss-144	netflix streaming services inc.
st-157	stack8 technologies inc.
strate-21	strategy first inc.
stu	st. thomas university
summit-3	summit rehabilitaion inc.
suncor	suncor, inc.
superg	supergroup/maclaren lintas
swcg	sterling west credit group
switc-23	switch incorporated
swp-6	seatrout web publishing
tbwaw	tbwa chiat day
tci-2	trilan communication informatique inc.
tcl-3	texxen consulting limited
tel-1	tellier electronics ltd.
teleni	telenium
telepr-1	telepresence systems inc
telese	teleserve canada inc
tfi-12	tech futures interactive inc.
tmp-30	titan media partners
tsc-1	tsc shannock corp
tss-236	total server solutions
unislu	unis lumin inc.
uptonr	upton resources inc.
urcs	university of regina
utilis	utilisoft inc
vfsmd	vancouver film school - multimedia dept.
vgh	vancouver general hospital
voxte	voxter communications, inc.
wc-56	world-link communications inc
whistl-14	whistler.com systems, inc.
wrcfs	west region child & family services inc.
wtcc-4	welded tube of canada corp.
xsoli-2	xsoli inc.
zepfte	zepf technologies inc.
8rl	+8 records limited
915498	915498 ontario inc
aastra	aastra corporation
aat-1	arts alive tickets incorporated
abcomp	a & b computers
abu	atlantic baptist university
acl-99	allo communications llc
activ-19	activo inc
adena	adena springs north
ag-472	aldo group inc
ahfmr	the alberta heritage foundation for medical research
airvm	airvm inc.
aitc-4	ait
aliste-1	alis technologies inc.
amcnd	athol murray college of notre dame
anders-5	andersen consulting
andq-1	assemblee nationale du quebec
area13	area13
asc-32	array systems computing inc.
atb	atb financial
aztec	aztec
bc-1231	bai canada inc.
bdl-37	broadband dynamics llc
bella-23	bell aliant / customer assignments
beresk	bereskin & parr
bfs-6	briercrest family of schools
bmc-163	brimedia
braksy	brak systems inc.
builda-1	build-a-mold
bvpd	buena vista pictures distribution
cabano	transforce
canad-107	11877895 canada inc.
canad-34	images et technologie
canad-9	canada web hosting
casca-56	cascadeo corporation
cbs-3	challenge business systems
ccsbl-1	corporation centrale de securite b.p.g. ltee.
ccw-26	corporation of the city of windsor
cdisj	carrefour de island saint jean
centr-26	centre nad
cfer	c-fer
ch-1130	cartero holdings inc.
cis-332	cgi information systems
citade-1	citadel assurance
cl-2216	cerium llc
cmh-107	centerfield media
cnl-166	co-link networks ltd.
cnr-5	canadian national railway co.
colleg-11	college bois-de-boulogne
colleg-14	college heritage
comput-25	computan
cti-3	carriere technical industries
dac-4	datacor/ism atlantic corp.
danni	dannielle holt
digidy	digidyne inc.
dl-695	dot-tech llc
dotal	dotalliance
dsl-3	dcs systems ltd.
dtroni	dtronix
ebt-11	electro byte technologies inc.
ec-597	evolve communications inc
eil-77	everythink innovations limited
electr-60	electronic arts, inc.
en-128	eau noire inc.
epdm-1-z	ecole polytechnique de montreal
era-18	electronic recycling association
eskeri	esker inc.
etsb	eastern townships school board
fis-47	fastwebserver internet services inc
flemin-2	sir sandford fleming college of applied arts and technology
forti-26	fortisbc inc.
fusixc	fusix corporation
gc-346	groupe canam
gel-363	gene's telecom
genimo	genimos data inc.
ggl-89	gaire group llc
ggt	gt group telecom inc.
gkc	george kelk corporation
gmcr-5	green mountain coffee roasters, inc.
gmmhd	government of manitoba
gms-178	gary manuel salon
gpv	goodman phillips & vineberg
gqgq	gouvernement du quebec (government of quebec)
gtl-855	grand and toy
gts-2	g.t.s.
gvpl	greater victoria public library
hcd-13	hearthstone consulting & dvmt
hmsc-5	huntsman marine science centre
hosti-20	hosting services, inc.
ibmca-3	ibm canada
icao	international civil aviation organization
icg-2	international computer group
iec-2	ibm eduquest canada
igat	internet gateway corporation
igcash	ig-cash
iidt	institut international des telecoms
infoma-1	infomatch communications inc.
intel-81	intelletrace
ipwc-1	ip plus wireless corporation
is-883	iteraweb solutions inc.
isc-154	internet security - ca
ists-1	ists
itc-24	infomagnetics technologies corp.
jakeco	jakeco developmnets
jh-205	just hosting inc
kis-31	kootenay internet services
kls-1	kd lan solutions
lcicl	le centre informatique cisj ltee.
lecha	le chateau inc.
lgsgro	lgs group, inc.
lifst	l&t infotech financial services technologies inc.
lpl-5	london public library
lpl-6	lb products ltee.
martr	martron inc
mbg-3	milinx business group inc.
mcgill-z	mcgill university
mcl-139	mercer (canada) limited
mct-2	megasys computer technologies
mdl-70	mybc datacom ltd
mdlsedss	ministere de la sante et des services sociaux
media-151	media group
memote	memotec communications inc.
metco-2	metcom network services, inc.
metrow	metrowerks inc.
micel-1	midwest internet cooperative exchange llc
middl-54	petiak
minned	minnedosa collegiate
monenc	monenco agra
moneyl-5	moneyline
mosaid	mosaid technologies incorporated
msc-11	ms society of canada
msc-30	myra systems corp.
multim-1	multimedia house
mwl	music world ltd.
ncf-18	national capital freenet inc
necn-1	nb-pei educational computer network
nestll	nest, llc
netcit	netcity inc.
netrou	netroute communications
networ-26	network studios
nexus-1	nexusds.com
ngl-1	neill & gunter limited
novus-3	novus entertainment inc.
ntl-14	ndc technologies, llc
nygh	north york general hospital
ocd-1	online computer distribution
oh-110	orthotic holdings
oh-112	orthotic holdings
oh-115	orthotic holdings
onden	ondenet inc
ontar-40	velcom
org-91587	9158-7147 quebec inc.
pacifi-16	pacific interconnect inc.
pdcs	pulse & digital computer services inc.
pdsl-2	prior data sciences limited
planet-2	planete quebec, inc.
pm-32	plentyoffish media inc
pms-3	park medical systems inc.
portag	portage group
prl-10	palliser regional library
prl-9	parkland regional library
proeng	pro engineering inc.
pronex	pronexus inc.
psi-2	psinet, inc.
psti	parasun technologies inc.
qoc	quaker oats of canada
quadr-43	quadranet, inc
quebe-74	alliance telecom
rca-9	r. caswell & associates inc.
rdc-5-z	red deer college
rel-41	rhoann enterprises ltd.
reseau-5	reseau admission
ris-7	rezonet internet services
royal-61	royal bank of canada trust corporation limited
rtcc-1	radium technology centre (canada)
rtt	rand technologies (toronto)
ru-2	unilink networks inc.
sc-3418	springtel
scc-31	sea change corporation
sdrdq	societe de radio-television du quebec inc.
shb-17	surfboard holding b.v.
shcl	simard hamel communications ltee
sjhho	st. joseph's healthcare hamilton
softt-2	softtel
softwa-23	software 2000 inc.
soge	sogetel inc
soren-7	sorenson communications, inc
ssl-6	strata software ltd.
sswc	sandelman software works corporation
strath	strathcona county
summit-2	summit rehabilitation inc.
swanec	sasktel wide area network engineering center
tcb-18	town & country bank
tcl-7	touch communications ltd.
tcp-2	texaco canada petroleum inc.
tdc-12	tawich development corporation inc.
teckco	teck corporation
thecan-1	the canadian institute
theobj	the object people
thepin-1	the pinetree domain
thind	thindata inc.
thomas-78	thomas & perkins
tic-4	toronto internet cooperative
to-60	town of orangeville
totali	total internet inc.
tpn-4	terago ptp networks inc.
tssl-2	performive llc
ttc-106	ttc
tuc-3	transalta utilities corporation
tugnet	tugnet enr
tvdsb	thames valley district school board
tzulo	tzulo, inc.
ugc-1	universal gateway corporation
video-39	videotron ltee
vins	flexential colorado corp.
virtua-39	virtual servers
vis	vianet
vse-1	vancouver stock exchange
vsl-7	virtual servers llc
vsl-8	vercom systems ltd.
vuc	virtual universe corporation
wbl-30	weston bakeries limited
wcba-1	worker's compensation board alberta
wcss-1	westview centennial secondary school
webhe	webhelp.com inc
webse-3	webserve canada
wfwl	william f. white limited
wie-5	winnipeg internet exchange
wifib-1	wi-fibre inc.
wig-9	western i.t. group inc.
wiml	w3 international media ltd.
wisl-1	wk information systems ltd.
ws	weathercity services
ww-184	web wizards
xnsl	xana network systems ltd.
xscar	xscargo
2ics	2ic systems inc.
aac-3	agt advanced communications
abut3	armature business unit, take 3
acca-2	allstream corp.
accc-1	colleges and institutes canada
accent-10-z	accenture llp
alpha-13	alphaomegahosting.com
ama-2	alberta medical association
andq	assemblee nationale du quebec
aniqlt	aniq ltd.
apfc	asia pacific foundation of canada
asds	automated software design systems
at-357	acrobat telecom inc.
athaba-z	athabasca university
b13	beanfield 1ip /30nets
bcqwis	bell canada quebec wireless internet service
bic-2	brother international corporation
big-2	bombardier inc.
bn-269	taridium canada
bombar-2	bombardier, inc.
brock-3	brock solutions
canad-54	4544188 canada inc
canad-79	netxpoint
caner	caneris inc.
cani	consolidated access & networks, inc.
ccc-28	canadian cardiovascular collaboration
cccl	conner clark and company, ltd.
ccinet	cci networks inc.
cda-3	com dev atlantic
cdj-2	cegep de jonquiere
cds-8	cegep de saint-hyacinthe
cdtcl	carswell, a division of thomson canada ltd
cdv-2	cegep du vieux-montreal
cehi-1	clearstream energy holdings in
cfpl	canadian forest products ltd.
chan	chancery software ltd.
chatsu-1	chatsubo design
citc	citizens telephone cooperative
cityof-53	city of saskatoon
cmhc-1	canada mortgage and housing corporation
cml-1	com-cept microsystems ltd.
cml-34	cgl manufacturing ltd
cncpte	cncp telecommunications
codm	college o'sullivan de montreal
colleg-36	college boreal
combyn	combyne data inc.
corede	coredev enr.
crcn-1	campbell river community network
create-11	m & r
crfs	corefusion
csa-14	city of st. albert
csdd-1	commission scolaire des d=e9couvreurs
cstail	c.s. taillon
dataco-1	datacor atlantic
didoi	dido internet inc
diggat	digga tech
dncl	dramis network cabling ltd
dsg-22	the descartes systems group inc.
dslo	dslonramp
dsn-15	data security node inc.
dteh	delta toronto east hotel
dtx	distribution trans x
dva-4	department of veterans affairs
ebaeng	eba engineering
echoon	echo online
ecicon	eci consulting
edap	edaptivity.com inc
eekage	eek.a.geek
eesl	e & e seegmiller ltd.
elect-42	electro-informatique michaud
empres	empress software inc.
entrep	entreprise twinmind
epl-11	edmonton public library
escher-1	escher grad
esna-1	esna
essen-24	essensys inc.
fastla	fastlane technologies inc.
fcf-22	first calgary financial
fcl-4	ferst consultants ltd.
fd-128	first databank, inc.
fse	footprints software and electronics
fsl	future shop ltd.
gcg	gwe consulting group
geosi-2	geosign corporation
gfs-2	gateway file systems
grh-1	glenrose rehabilitation hospital
gsal-27	prairie-sky wireless
gsg-22-z	acceo holding inc.
gtgc	gt group telecom inc.
gx	xcd telecom
gyra	gyra
hi-117	hub international
hm-40	hootsuite media inc.
hmplo	hub meat packers ltd. ( o/a
hs-291	hextet systems
hsc-9	the hospital for sick children
hsst	hard soft systems ltd.
ics-22	imt communications systems inc
il-131	iwantwireless.ca ltd.
imed	intermedia.net, inc.
induss	indus systems
infoin	infointeractive, inc.
instit-23	institut maritime
inter-1440	internetbusinesscorp.com
intert-3	inter.tain.net
irml	intech risk management ltd.
ismg-1	ismg
isyst	i-syst
it-510	imad telecommunication inc.
jac-14	john abbott college
jil	jd irving limited
jucht	juch-tech inc
kdda	kddi america inc.
kis-13	kneehill internet services
konl	kingston online services
labor-3	laboratoire dermo-cosmetik
laidla-1	laidlaw
lambto	lambton college of applied arts and technology
lanark	lanark technologies inc.
larain	lara investments
lc-1186-z	lactalis canada inc.
lccdg	la capitale, cie d'assurance generale
lcl-43	loblaw companies limited
ldr	legal data resources
lgd	le groupe dmv
linod	linode
lkdsb	lambton kent district school board
lpcl-2	lions park computers ltd.
madge	madgenius.com
mag-50	mark anthony group inc.
malofi	malofilm distribution inc.
mcc-55	mcc
mcecdq	ministere culture et communications du quebec
mchc	marine corp historical center
mda-1	macdonald dettwiler and associates
mediah-1	mediahost inc.
mediao	media online
mediso-1	medisolution inc.
mesl	matrox electronic systems ltd
micha-54	michaud technologies inc
mlbl	maritime law book ltd
mlls	ministere de l'education, du loisir et du sport
mmc-324	mohawk medbuy corporation
moder-60	modernworks inc.
moxie-3	moxie communications, inc.
msi-3	the iteam ltd.
msl-8	mcdougall scientific ltd
nbpcl	new brunswick publishing company ltd.
ndl-1	northwest digital ltd.
nesbit-1	bmo nesbitt burns inc.
networ-21	networx
nfbc-2	national film board of canada
nfm-19	nebraska furniture mart, inc.
nha-14	northern health authority
nnc	netnation communications inc
noi	national optics institute
noi-1	national optics institute
np-41	newfoundland power inc.
nrcml	newcrest red chris mining limited
oesul	onx enterprise solutions (us) ltd.
omcu	ontario ministry of colleges and universities
omnive	omni ventures inc.
oo-6	orcas online, inc
orgin	orgin data inc
pallis	palliser furniture
pbsl-20	polarcom
pctc-7	pbsc computer training centres
pfg-12	ppi financial group
pfizer-1	pfizer canada, inc.
phl-35	pachez holdings ltd.
pl-1183	perimeter 81 llc
pl-892	postageapp
ppc-1	plc powerlink corporation
proma-3	promax
proto-5	protologic.com
proven	proven systems
ptciek1	primus telecommunications canada inc. -eastern-016- kin 1
pubco	pubco
public-28	publications transcontinental
pucts	providence university college & theological seminary
qss-7	quick service software inc.
radc	radiant communications ltd.
rcocon	rco consultants
rdc-80	rogers data centres
resou-4	resources canada
rim-1	rezo i media
ris-20	resource information systems
sykora-z	sykora technology inc.
tandat-2	tanda technologies inc.
tcl-2	texxen consulting limited
tcl-458	tepa connect llc
tcv-10	telecommunication carl verreault inc
teleco-86	telecom ottawa inc.
teleme-1	tele-metropole
telzon	telzone wireless inc.
thefre-6	the free network
thega-20	the garland group
thevid-1	the video doctor
tia-46	team internet ag
tins	the internet shop inc.
tis-152	truespeed internet services
tna-26	t-systems north america, inc.
todyl	todyl, inc.
treb-4	toronto real estate board
ts-1	teksavvy solutions inc.
tssl-16	total server solutions l.l.c.
tvonta	tv ontario
tws-10	toronto web services inc.
ultima-2	ultimate technographics inc.
vcha-3	vancouver coastal health
vinta-11	vintara
virgi-42	virgin technologies inc
vmedi	vmedia inc
voxtel-1	voxtel.com
vsi-15	virtual space international inc.
wbg-1	whitman benn group inc.
wel-1	wilson equipment, ltd.
wwwork	wwworks inc.
xenong-1	xenon genetics
xtcl	xicom technology canada limited
abl-287	aurora broadband
accubi	accubid systems
acomco	acom computer, inc.
agtltd	agt ltd
ami	applied microelectronics institute
angcl	alberta natural gas company limited
angztc	angzt-co
aptos-1	aptos canada inc.
art-2	alpa roof trusses inc.
asg-4	all systems go
asl-190	axia supernet ltd
at-9065	ardham technologies, inc.
ats-14	advanced training & services inc.
auc	augustana university college
barem-2	baremetal.com inc
barre-2	xplornet communications inc.
bcdpic	british columbia drug and poison info centre
bci-40	bell canada - iptv
bclc-1-z	british columbia lottery corp
bdc-5	barrett diversified corporation
bellid	bell (idc)
bellm-8	bell mobility, inc.
bma-1	bc medical association
bps-120	bellwyck packaging solutions
bragg	eastlink
bt-1266	babish telecom
bu-182	boyne usa, inc.
campne	campnet inc.
canad-86	datacity
cciraacplei	cira canadian internet registration authority autorit canadienne pour les enregistrements internet
cdc-3	canoggis databank corp.
cdedcet	centre d'expertise et de consultation en tourisme
cdsab	centre regional de services aux bibliotheques publiques (c.r.s.b.p.) de la monteregie inc
chc-207	corporacion hostingssi c.a
chkent	chk enterprises
cityof-45	city of peterborough
clc-4	cross link computers
cls-11	cls
cmd-2	canadian micro development
cognos-2	cognos inc.
commun-33	communications mednet inc.
conne-20	connections canada inc.
contr-81	controld inc.
costco	costco companies, inc.
cra-25	conestoga rovers and associates
crn	canadian research network
cw	columbia wireless inc
cyberc-40	cybercamps.com
cyberw-1	cyberwave technologies inc.
datac-46	datacate inc.
dbe-1	dryden board of education
ddsau	dds automated machinery design
del-1	dynacon enterprises limited
demark	demarkation inc
dems-4	direct energy - managed sharepoint 2007
dnsc-1	dedicated net services corp.
doc-14	broadridge customer communications canada, ulc
dolfin-1	dolfin developments
dptc	digital payment technologies corp.
dtka	dr. t.a. kasper and associates
educat-2	education innovations
eid-6	epi intenet direct
empres-1	empress software, inc.
epbe	east parry board of educatiion
ets-120	epk training solutions inc
ezprov-1	ezprovider inc.
factav	facta vera
fcc-3	farm credit corporation
fibre-1	fibrenoire inc.
firee2	fireeye, inc.
flash-34	flashtalking, inc.
fms-4	first marathon securities, inc.
fordq	federal office of regional development of quebec
frsh	freedman sharp and associates
gbeg	geraldton board of education - geraldton
gis-172	genesys it solutions
globa-438	globaltel
global-258	global connexxions inc.
gnccl-1	gosfield north communications co-operative limited
gnt	government of the northwest territories
goldl-3	gold line telemanagement,  inc.
gtaa-1	gtaa
gtl-210	gpi technologies llc
gwc-1	glegg water conditioning inc.
hd-3633	halton datacenter inc.
hdsb-4	hamilton-wentworth district school board
hh-63	hawk host inc.
hmhss	hicks morley hamilton stewart storie
hsa-20	henry sehein arcona
huc-3	hamilton community energy
iata	international air transport association
iboss-2	iboss
icac	ica canada on-line inc.
icl-75	infosat communications lp
idrcdm	institut de recherches cliniques de montreal
igfs-1-z	investors group financial services inc.
ih-47	innovite health
ihs-29	internet hosting servers
ils-1	icc learning services
imagei-3	image impression inc.
imper-61	imperium inc.
incc	atlantic.net, inc.
infern	inferno enterprises
innova-6	innovasys
ipp	internet payment process inc.
is-257	ifly seattle
ismcor	ism corporation
ist-59	innovative scaling technologies inc.
isu-19	internet security - us la
iwt-9	isohunt web technologies, inc.
jcl-31	tough country communications ltd.
jec-3	journey's end corporation
jeolus	jeol usa, inc
jgh-z	sir mortimer b. davis - jewish general hospital
ka-354	kit and ace
kagll	keaton alexander guger lair
kitche-3	kitchener-wilmot hydro
kmtsi	kmts internet
kulian	kulian consultants
laval-2	lavalife corp.
lci-3	learn-ed consulting (international)
lcl-140	logix
lifet-301	lifetouch inc
luniqu	l'unique
marque-1	onscope group inc.
mcans	metro community access network society
mccsys	mcc systems
mcg-73	mid-range computer group inc.
mchsol	mch solutions
mda	macdonald dettwiler and associates
merbr	merbridge networks
mfl-1	mccain foods ltd
mhc-3	mclean hunter communications
mi-1460	microcom informatique, inc.
mics	minister of industry, commerce, sciences and
mllc	manitoba liquor and lotteries corporation
mpip	manitoba public insurance corporation
msl-5	microstar software limited
msrg	masergy communications, inc.
navig-5	navigata communications
nb-368	northern backup incorporated
nbphc-z	new brunswick power holding corporation
ncc-11	national capital commission
newlin	newlink telecommunications
nhm-8	north hill mazda
nidusc	nidus computers
noca	northern cable holdings limited
novic-5	novicom 2000 inc.
nsa-53	network security associates, inc.
nserc-2	natural sciences & engineering research council
nt-65	nexeon technologies, inc.
nutech-4	nutech digital
nwpl	new westminster public library
nyh	north york hydro
ocl-2	olivetti canada limited
openv	open vision, inc.
orill-1	orillia pronet, inc.
packe-25	packetexchange, inc
pacw	packetworks inc.
padvac	pathix asp
parc	pacific aids resource centre
pbi	prairie bible institute
pcgbas	pcgbase inc.
peer1i	peer1 internet
pfg-33	ppi
phcu	board of health for the peterborough county-city health unit
pis-23	poke internet services
portof	port of montreal
psc-8	public service commision
ptciee1	primus telecommunications canada inc. -eastern-037- eds 1
ptcipw1	primus telecommunications canada inc. -pacific-021- wnp 1
qm-5	quickplay media inc.
rc	reliance communications, inc.
resint	res international inc.
rjl-8	raymond james
rmdeve	r.m. developers
rom	royal ontario museum
rrcaast	red river college of applied arts, science and technology
russel-1	russel & dumoulin
rwbr	risq web-hosting bloc
saskte-1	sasktel mobility
satel-6	satelcom internet inc.
sbgh	saint boniface general hospital
scaat-1	sault college of applied arts and technology
scc-22	streamwave communications corp.
schlu-3	schlumberger limited
scribe	unus, inc.
scsl-45	shaw cable systems ltd
sdhu-1	sudbury & district health unit
sdi-70	silicon desert international, inc.
sdn3	school district no. 39
shb	saskatoon health board
shopi-1	shopify, inc.
siduss	sidus software inc.
siisl-1	south island internet services ltd.
sis-42	spectrum investment systems inc.
sixth	sixth gear direct
snic	sonic.net, llc
sns-3	supro network software, inc.
spect-111	netspectrum wireless internet solutions
spence	spencer stuart
sscl-30	sniper satellite & comunications ltd
ssl-76	syban systems ltd.
sss-183	shaw satellite services, inc.
synchr-3	synchronics limited
synpha	synphar labs inc.
systro-2	systronix enterprises inc.
tamec	tamec inc.
tbec	telebec
tc-362	tata communications
teklog	teklogic inc
tgdhn	tnd graphics dba horizon net
thecom-2	the computer shoppe inc.
tpn	terago ptp networks inc.
tsg-17	trapeze software group
ubc-3	university of british columbia
ucc-1	united church of canada
unbc	the university of northern british columbia
unicom-4	unicom online
unioni	union inc
uol	uniserve on line
uptim-1	uptimearchive, inc.
utl	unibase telecom ltd.
vdk	ville de kirkland
viane-4	vianet inc.
vmg-11	vintacom media group inc.
vmt-1	valiant machine and tool
vnl-57	valo networks ltd.
vpl	vancouver public library
vs-59	varicent software inc.
wcl-3	westlink communications ltd.
wid-7	webair internet development company, inc
wiso	wisol inc.
wlar	whiteshell laboratories, aecl research
xenonl-z	xe.com inc.
xplor-3	xplorenet
youro	your.org, inc.
risq-z	reseau d'informations scientifiques du quebec (risq inc.)
rmw-2	region of waterloo
rsi-28	rep solution interactive inc.
rsmri-3	rsm richter management ltd.
sapat	sapatana
sca-4	southshore community access
scc-25	stone consolidated canada
scnm-2	stentor canadian network mgt.
scs-6	simtech consulting services
scu-143	synamedia
serve-33	serverbeach
sht	saskatchewan highways and transportation
sieal	sony interactive entertainment america llc
sl-669	system lifeline inc.
softar	softarc inc.
sp-243	sae power company
spect-29	spectrum
sprn-z	sprint
srtele	sr telecom inc
ss-34	skycomp solutions inc.
st-635	salmon terminals inc
starga-1	stargarden corp
sunset	sunset communications
surfc	surfcontrol, inc.
svh-1	sanford health
swbc	science world
swp	viterra, inc.
sybase	sybase, inc.
tace	telus communications inc.
tamils	tamilsoft corporation
tc-94	telehop communications inc.
tcr	texaco canada resources
tds-7	thompson dorfman sweatman
tdsb-1	toronto district school board
terran-1	terran communications
tfs-11	tritech financial systems inc.
theglo	the globe and mail
timber	timberjack, inc.
torine	torinet systems, inc.
traff-6	traffix inc.
trave-94	travelbrands inc
trlab	tr labs
trnd	cybertrends inc.
tssl-34	total server solutions llc
twitt	twitter inc.
ugomed	ugomedia.com interactive, inc.
unit-1	unit4
united-5	united breeders, inc.
univer-183-z	university of victoria
univer-289	university of windsor
univer-369	universal digitech
usi-1	utex scientific instruments inc.
v3med	v3 mediaworks
vhl-59	vultr holdings, llc
voipl	voip logic
vrevl	vrev ltd.
walsha	walsh automation inc.
wcl-16	western canada lotteries
webnx	webnx, inc.
woodyn	woodynet
ws-46	websan solutions inc
xc-87	airfib
yiecl-1	yegix internet exchange community ltd.
yourl-2	yourlink inc.
zercom	zercom technologies inc.
170260	170260 canada inc.
ac-5078	aldera communications
aes-120	ascent energy services inc.
akrans	akran systems
al-1519	crossfire information systems
al-8	whipcord ltd.
alphac	alphacom
alters	altersys inc.
alvina	alvin austin co.
antelo	antel optronics inc.
asdc	amdahl software development centre
au-187	automattoque
bankof-2	bank of america, national association
batali-1	bata limited
bdb	bell direct/tele boutique
bdio	bell dsl internet ontario
bellvp	bell (vpne)
bf-208	bullitt foundation
binnj	binnj inc.
bns-113	bank of nova scotia
bpc-76	bluewater power corporation
bpl-3	barrington petroleum ltd.
brwb	blue ridge websoft, llc
bt-430	brama telecom
btnet	bt networks
btvc	bluewater tv cable, limited
buhler	buhler industries inc.
calexi-1	calexis advertising
cantre-1	cantrex group inc.
capri	capris group
cb-260	city of burnaby
cbey	cbeyond communications, llc
ccl-227	cohere communications, ltd
ccp-4	central canada potash, inc
ccscu-1	coast capital savings credit union
ccu-1	cambrian credit union limited
cgccl	canadian greeting card corp. ltd.
ch-1191	cypherpunk holdings inc.
chedok	chedoke-mcmaster hospitals
clear-129	clearwave broadband networks inc.
clear-98	clearcable networks
cm-124	cleveland metroparks
cm-142	cnsx
cme-95	capital music east
cndce	comm. nord-americaine de coop. environmentale
cnut	central utah telephone, inc.
coffee	coffeehaus, inc.
commis	commission de la sante et de la securitie au travail
commun-11	communications inter-acces
conbri	conbrio teamwork, inc.
concor-6	concordia university of edmonton
cpbcl	central park business centre ltd.
crs-3	cashhandler retail systems, inc.
csc-434	commission scolaire des chenes
csdc-4	commission scolaire de coaticook
csds-1	commission scolaires des sommets
ctcf-1	diffusion fermont
cybers-37	cyberstore systems inc.
das-136	dsv air & sea inc.
datto	datto, inc
digis-4	digisync
distr-2	district of squamish
dpsl-1	dynamis productivity software ltd.
dsc-8	dkw systems corporation
dsl-43	dm&t services ltd
dtl-118	dr technologies ltd
durand	durand and associates
ecc-32	emi communications corp.
echoco	echo communications
ecs-3	eri computer systems
edtc	edmonton telephones corporation
electr-8	electrobyte technologies
entrev	entrevision inc.
esl-62	evsl
et-76	execulink telecom inc
etfo-1	elementary teachers federation of ontario
flemin	sir sandford fleming college of applied arts and technology
flt	fast lane technologies
fredde-1	fred deely
fronti-30	frontier computer
fsl-4	hampson-russell software services ltd.
gozoo	gozoom.ca inc.
gpei	government of prince edward island
gsl-3	gm supergroup/maclaren lintas
gssl-8	global smb solutions ltd.
gtlp	goco technology limited partnership
gva-1	galloway, venus and associates
hacl	hustad associates consulting ltd.
hbe-1	the halton board of education
hch	hamilton civic hospitals
hhtech	h&h technologies inc.
hpe-15	hewlett packard enterprise company
hsl-2	herzig somerville, ltd.
ht-344	hd telecom inc.
hurc	hurricane electric llc
hydrom	hydromantis inc.
hypix	hypixel, inc
ic-1126	ixica
icl-14	ibm canada ltd.
imaxco	imax corporation
inm	isotro network management inc.
intel-222	intellinet
ipcom-1	ip communications
isbc	internet service bureau of canada
isc-7	iset software corp.
ismb	information systems management, b.c.
ismc-1	information systems management corporation
ivct	i voice comm telnetwork inc
iwc-3	the internet world cafe
jannas	janna systems inc.
joel	computer data products
jsic-1	jade simulations international corporation
kc-81	kiewit corporation
kcl-3	kalium canada, ltd.
kenot	kenotronix inc.
keopsi	keops technologies inc.
kit-3	kerberos information technology, inc.
korsai	korsa international
la-575	lightica
lc-1186	lactalis canada inc.
lcl-4	lacure corporate and leisure, inc.
lm-217	lionsbay media inc.
logici	logiciels object inc
lpr-7	linkbynet
marit-6	maritime college of forest technology
marsha-8	marshalls inc.
mcics	mci communications services, inc. d/b/a verizon business
mctrf-1	manitoba cancer treatment and research facility
mdfs	government of manitoba
meteom	meteomedia
mipp	mipps inc.
mli-3	the manufacturers life insurance company
mrcim	mcgill research center for intelligent machines
mrs-2	moore resource systems
msil-5	msi systems integration ltd.
msimar-1	msi marketing inc.
msscon	mss consulting
mulvey	mulvey agency
mvsus	mvs usa
nccim-1	new creation consulting & information management inc.
nccsc	north cariboo community skills centre
ncl-68	nome consulting ltd
ncste	ncs technologies
nml-2	newnes machine ltd.
nndsb-1	near north district school board
novala	novalab ltd.
nrncom	nrn communications
ntpv	network technology professionals of vancouver, inc.
object-7	objectime limited
occu-5	oanda (canada) corporation ulc
od-8	ovh (dal)
ol-348	rural net connect
ontar-51	2217869 ontario inc.
osite	ositech communications inc.
paxser	pax services
pcscav	pc scavenger
phc-81	prestige hospitality corp
pivot-5	pivotal payments
polari	polarix, inc.
ports-9	ports america, inc.
ppi-4	productivity point international
ppm-2	pc party of manitoba
pr-523	packet rabbit inc
pronet	pronet communications inc.
protek-1	protek computers inc.
ptpb	point to point broadband inc.
qlsyst	ql systems, inc.
rdsyst	rd systems
redlan	redland quarries inc.
rt-60	rbbs telecom inc.
rvh	royal victoria regional health centre
sandri	sandrix technologies inc.
sbe-2	saskatoon board of education
sccl-2	surf city communications ltd.
scwl-7	schneider's computing & websites ltd.
sd4-1	school district #42
sd6	school district 69
sd6-1	school district 69
sel-5	stardust enterprises ltd
softl	softlayer technologies inc.
spas-2	st. paul the apostle school
sph-32	sheraton parkway hotels
aat-2	apex advanced technologies, inc.
ac-2678	apsis communications inc
acadia	acadia university
acc-372	afilias canada, corp.
acg-115	aptient consulting group inc.
adpes	automatic data processing, inc.
ag-638	arrow group inc.
aiss-2	atos it solutions and services inc.
al-662	accomplishmail llc
ant-5	aurora network technologies incorporated
aptd	service alberta
asf-3	advanced server farm
asg-10	automated systems group
aupelf-1-z	auf
ballar	ballard consulting
banl-1	beyond air networks limited
basf-2	bgs advanced server farm
baycom	baycom inc.
bcrc	british columbia research corp.
bdia	bell dsl internet - atlantic
bht	bell helicopter textron
bie	blizz informatique enr.
bihl	b.c. info health ltd.
bis-7	bina information services inc.
bns-1-z	bank of nova scotia
brs-3	bc rehab society
bssm	bell sygma systems management inc
btc-107	bh telecom corp.
campan-z	campana systems inc.
canad-85	kusat
canad-87	navigata communications limited
canad-89	lulu software
canade	canadelle incorporated
canadi-3	canadian-moroccan assn.
carain	cara informatique
catie	canadian aids treatment information exchange
cbe	calgary board of education
cc-475	cologix canada, inc.
cccsc	cariboo chilcotin community skills centre
cds-10	cegep de saint-jerome
cgbc	centra gas british columbia inc.
chm	centre hospitalier mont-laurier
cityof-75	city of london
cmdt	college moderne de trois-rivieres
colleg-4	college edouard-montpetit
compug-1	compugard services
coolwa-1	coolwater
corela-1	corelan communications, inc.
cpane	cpanel, llc.
cpcsl	can pay computer software ltd.
cppib-2	canada pension plan investment board
csdcf	conseil scolaire de district catholique franco-nord
ctl-9	cybcom telecommunication limitee
cucbro	cuc broadcasting
cwc	canada wire and cable
czs	calgary zoological society
dcaas	durham college of applied arts & science
ddlspd	direction de la sante publique de
dstcor	dst/corfax systems
dtcs	double t computer services
duc-2	ducks unlimited canada
durh	durham net inc.
dynam-75	dynamic asp inc.
ecolep-1	ecole pointe-des-chenes
embere	ember ec3 inc
enhanc	enhance systems inc.
etc-11	eicon technology corp.
flexi-7	flexity solutions inc
formu-4	formula 1
fseti	fset inc
fuller-11	fullerene productions
gd-91	vmpanel
glbhc	great lakes bay health centers
groupe-6	groupe educalivres inc.
gst-13	greater sudbury telecommunications inc.
gtomni	gt omnicom inc.
gvrd-1	greater vancouver regional district
gwl	george weston ltd
hac	holstein assn. of canada
hamilt-3	hamilton-wentworth freenet
hch-43	havas canada holdings inc.
hcu-9	hush communications usa
hisbh-4	hampton inn and suites by hilton
hl-277	hll llc
hmdcl	hibernia mgt. and development co., ltd.
hollow-1	holloway studios
hosth-2	hosthatch, llc
hp	hewlett-packard company
hr-233	hammerhead resources inc.
hsppl	howe sound pulp and paper ltd.
htlh-23	h4y technologies llc (host4yourself.com)
ibc-66	insurance bureau of canada
ibm-1-z	ibm
icod	international centre for ocean development
ieenet	iee network
ii-24	idigital internet inc.
iit-7	island information technology
imagea	imageaide inc.
inform-44	informatique osg inc.
inter-83	interserver, inc
intern-73	internet-bbsi inc.
inver-1	invera inc.
isc-10	information superhighway corporation
isgtec	isg technologies inc.
island-1	island computers
it-80	iaak technologies inc.
ivalu	ivalua inc.
izaak	izaak walton killam health centre
jmsl	junior mine services ltd.
jsal	j.d. scown and associates ltd.
kosmos	kosmo solutions
launch-2	launchpad software
lc-202	langara college
lcc-11	light computer centre
lcs-141	line-tap computer service
le-108	lilani enterprises inc.
lgcl	l. & g. consultants ltd.
lionr	lion resources, inc.
lomdl	log on multimedia designs, ltd.
malett	malet tech.
mandac	m and a communications
mcs-19	magtech computer services inc.
mdgs	government of manitoba
mdhch	latisys-chicago, llc
mentor-2	mentor networks, inc.
microb	micro-boutique inc.
midwe-12	midwest surveys inc
misl	mainland information systems ltd.
mn-395	mage networks inc.
most	magic online services toronto inc.
mssl-17	microsemi storage solutions ltd
mtpf	toronto police service
nbc-2	the national ballet of canada
ncdsb	niagara catholic district school board
ncie	national capital internet exchange
ncp-58-z	northern computer products inc
netaxi	netaxis inc.
netxs	netx systems inc.
nhs-31	netelligent hosting services inc.
nic-64	north island college
npl-1	net propulsion labs
npls-1	northern petrosearch land services
ns-197	3268120 nova scotia company
ocnl	operations & compliance network llc
ontar-62	globalvu
oracle-4	oracle corporation
osa-1	optimization systems associates inc.
ouac-1	ontario universities application centre
ovhin-2	ovh-internal
oyp	o & y properties inc.
pacifi-12	pacific academy
pc-2167	pelmorex corp
pcip-z	parsons corporation
pdsb	postal and distribution services branch,
pers	persona communications inc.
pht-10	peer 1 hosting toronto
pmib	paisley manor insurance brokers
pokein	poke internet inc
psi	psinet, inc.
psi-1	psinet, inc.
puc	peterborough utilities commission
qctc	quick commerce technologies corporation
qocl	quaker oats of canada, ltd.
quebe-76	tango nordik telecom
rcc-183	rogers communications canada inc.
rdpsd1	red deer public school district #104
rogidi	rogidi inc.
rpgl-21	rexall pharmacy group ltd.
rpn	reseau postotal network inc.
rq	agence revenu quebec
rtm	rolling thunder marketing
ryers-1	ryerson university
salon-9	salonfunrairedeme
scotia-2	scotia
sette	sette
sey	sobeco ernst & young inc.
sharp-24	sharp rock technologies ltd.
shin	saskatchewan health information network
sixnet	@six.net
sl-1146	sprious llc
softqu	softquad inc.
speed-80	speedfi inc.
speedw-2	fresche solutions inc.
aaasa	american association for the advancement of science (aaas)
aasc	adwall advertising systems corporation
abc-617	allstream business ca
acl-31	arctic co-op limited
acml	angus consulting management ltd.
acu-67	affinity credit union 2013
adl-7	agt directory ltd.
adsc-5	amazon data services canada
ag-1035	alera group
airall	air alliance inc.
allho	allhostshop.com
apnic	asia pacific network information centre
argust	argus technologies inc.
ascl-2	advanced scientific computing ltd
atob	autobahn access corporation
attw-z	at&t services, inc.
automa-5	auto mart inc.
basez-1	basez
bceeme-10	bce emergis
bcins	bell canada - ids network services
bdk	bibliotheque de kirkland
bdl-22	broadband dynamics, llc
bishop	bishop's university
bisp-1	blink internet service provider inc
blazet-1	blaze telecommunications
blc-171	bc libraries cooperative
bm-1364	bell mobility, inc.
bpt-1	bit pacific technologies incorporated
btsaps	st. albert public schools
cactus-1	cactus communications inc.
canad-97	7954689 canada inc
cb-1477	core broadband inc
cc-3056	cable cable inc
ccc-40	canaccord capital corporation
ccl-243	crystal computers ltd
ccl-370	cascadia capital llc
ccl-578	corp. of the city of london
cdc-12	cegep de chicoutimi
cds-254	cogecodata
cegepb-z	cegep beauce-appalaches
cg-342	ci2 group inc
cgiinc	cgi inc.
cgm	centra gas manitoba, inc.
chl-161	the core hosting llc
chl-9	coast hotels limited
cia-3	chipper internet access
ciaat	college of the north atlantic
cial-1	client instant access, llc
ciec-1	communicopia internet & envvironmental communications, inc.
cisl	canweb internet services ltd.
cityof-72	city of kitchener
cjcr	cegep joliette-de-lanaudiere, campus repentigny
cloud-98	cloud&more inc
cmimcm	connect
col-20	cara operations limited
colleg-23	college lionel-groulx
compuc-1	compucom
comput-29	computerlink online inc.
corene	core-net inc.
cranb	cranberry resort
cresce	crescent school
css-1	chubb security systems
css-374	cooperative de solidarite du suroit-csur
cstin	cst industries, inc.
ctisccb	citenet telecom inc. - subnetted class c block
cuds	universite de moncton - campus de shippagan
cyis	cygnet internet services inc
dcl-577	delta centric llc
ddlt	delta dentre for learning technologies
delcan	delcan corporation
digit-42	digitalproviders.net
dmhs-2	don mills high school
dta-1	dta
dwis-2	ddb worldwide - it services
eisc-1	execulink internet services corp.
emban-1	embanet corporation
etolli	etoll, inc.
fansha	fanshawe college
fansha-1	fanshawe college
fatspi	fatspider publishing
fsl-112	fgl sports ltd.
gapnet	gapnet technologies
globa-245	globalive wireless management corp.
gossa-1	gossamer threads inc.
grandm	grandmaster technonogy
grayma	gray matter
havent	haven technologies
hkup	hookup communications
husky-1	husky energy inc.
hvil	harvest vintage imports ltd.
ia-224	ipsos america inc
ices	inst. for clinical and evaluative sciences
inform-48	informatika
inter-1217-z	interior health authority
intern-173	internet lightspeed
interv-1	intervider comm. inc.
ios-14	infobahn online services
itwi	intown internet
jas	jesco automated services
jgc-4	j2 cloud services, llc
ji-85	jesta i.s. inc.
kcc-1	university college of the north
khsc-z	kingston health sciences centre
lfl-21-z	leon's furniture ltd.
lightr-1	lightrealm, inc.
lintas	lintas canada
lis-8	liberty integration software inc
lrlc	les reseaux lan cite inc.
lslchs	louis st laurent catholic high school
lsz	les systemes zenon inc.
marsul	marsulex inc.
mc-1760	m/a com
mekte	mektel inc
merl	merlin
messac	messa computing inc.
micros-14	microset systems, inc.
mit-3	marine information technology
mse-215	ms solutions
msh-11	mount sinai hospital
mt-43	mainland telecom inc.
nc-717	ncds canada
nete	netenterprise inc.
netin-11	net3 inc.
nettr	nettrac communications inc.
netwo-59	network solutions, llc
nflo	inflow inc.
nli-23	no limits internet
nms-127	ncs managed services inc
north-304	northern computer solutions ltd.
ocdot	metro loop
ocri	ocri
ocs-17	open communications system
oicr	ontario institute for cancer research
oldsco	olds college
ontar-55	gtaisp
ontari-3	ontario hydro
ontc	ontario northland transportation commission
openso-1	open solutions inc.
osc-3	ontario science centre
ot-84	allo telecom
ovw	oceana virtual worlds
pan	prince albert network
param-19	paramount pallet
pcp-1	perryscope concert productions
pdci-1	perth district collegiate institute
pdsl-1	prior data sciences ltd
peinet-1	peinet inc
peopl-76	peoplefluent
pharm-83	pharmascience inc.
pjfl	petit jean fiber
plati-14	platinum synergy
pokene	poke net
pphm	patterson palmer hunt murphy
primet-3	primetech electronics inc.
prior-7	priority colo inc
prisco	prisco tech inc.
psc-19-z	precise systems corporation
qnc	quadrant newmedia corp.
questz	questzones.net inc
rastan	rasta networks
rcolem	rcoleman
res-25	renfrew educational services
riq-1	reseau internet quebec inc
rnl-38	router12 networks llc
rsmedi-1	r-s media
rtg-1	redmond technology group inc.
sandbo	sandbox communications
sapien-1	sapience inc.
sc-1430	solium
scnm-1	stentor canadian network management
sdm-1	services documentaires multimedia
sdn6s	school district no. 62 (sooke)
serve-32	serverbeach
shaw-z	shaw communications inc.
shawc-2	shaw communications inc.
sidl	services internet de l'estuaire, inc.
siecor-1	siecor
siscai-1	sisca informatique inc.
smsl-1	snowy mountain software ltd
source-2	sources
speedl	speedline canada
spgc	spectrum global communications inc.
strate-57	strategicprofits inc.
stratf	stratford festival
switc-3	switchworks technologies inc.
targo	targo communications inc.
abc-7	atlantic business college
abtl-1	adaptive business tech ltd
aclt-2	rackco.com, tor
actlab	act laboratory
adc-26	a.d data consulting
agrico-1	agricore united
al-535	amazon.com.azdc, llc.
alfala	alfalab research inc.
alldom	alldomains.com
ambles	ambleside consulting inc
appli-18	applied systems, inc
art-31	automated rig technologies
as-3017	actrack solutions inc.
atcqa	caa quebec
avente	av entertainments.com
avenza	avenza software inc.
balanc-1	balan corporation
bct-2	british columbia television
bdlvdk	bibliotheque de la ville de kirkland
bel-65	baytex energy ltd.
bella-24	bell aliant / core-internetworking
bic-1	bombardier inc. canadair
blnl-6	big land networks
bms-28	bamfield marine station
brytec	bry-tech systems inc.
bsil	bonded services international limited
bss-9	burnt sand solutions inc.
bstl-6	bruce street technologies limited
bvgc-2	boone valley golf club
cabcc	canadian association of blue cross plans
canad-71	dataweb solutions
canadi	canadian marconi company
cbbc-3	columbia basin broadband corporation
ccl-10	computer concepts ltd.
cdc-13	cosan development corp.
cdl-3	cegep de levis-lauzon
cdr-1	cegep de rimouski
cds-12	cegep de sept-iles
cdspdq	centre de sante publique de quebec
cenov	cenovus energy inc
centr-280	centrilogiccanada
cica-1	canadian institute of chartered accountants
clover-1	cloverlink systems, inc
commi-7	commission scolaire de la cote-du-sud
compet-4	competitor communications inc
concor-12	concord technologies
connec-9	connectivity plus
cprsc	canadian pacific railway company
cuc-z	burman university
cvccc	clear view communications canada corp.
dadepa	imperialdade
dataa-3	data anywhere.net
datafi	datafix technologies
dcc-6	databyte consulting corp.
dictso	data i/o corporation, toronto syndesis operation
ds-180	dimensional strategies inc.
dundee-1	dundee securities co.
durab-1	durabledns inc
dzt	disturbed zero technology
ecobe	ecobee, inc
edc-83	estruxture data centers inc.
ehl-71	lee edward enterprises
ehtel	eh!tel networks inc.
eis-7	enterprise information systems, inc.
enviro-12	environment canada
fa-426	fibre argenteuil
fcl-1	forintek canada ltd.
fi-31	fdm4 international inc.
fibre-5	fibrestream, inc.
fleet-37	fleettel inc.
forkn	fork networking, llc
forsal	forsaleforrent
futurn	futurnet fm-seoul
gardew	gardewine north
geofit	geofit inc.
geovis	geovision corporation
ghd-7	lunavi, inc.
ghlx	global hyperlinx inc
greyca	grey canada
groupe-1	groupe quebecor inc.
hayat	hayatsat
hc-954	halo colocation llc
hi	h2h interactif inc
hi-49	hawkesbury igs
hit-7	huron internet technologies inc.
hscf	the hospital for sick children foundation
ia-1084	ipsos america inc
ib-337	imaging bay, inc.
ifs-3	iqon financial services inc.
ifsl-2	industrial forrestry service ltd.
ign-1	infinite global networking
iisi-1	isis (internet services and information
ik-3	igs kw inc.
ilm-15	intercap lending murray
inter-400	intertainment cafe
inter-934	interim healthcare, inc
interc	intercom
intern-30	internet jrv
iol	imperial oil limited
ird	international road dynamics, inc.
isqso-3	isq solutions inc.
ist-5	internet software technologies
it	it canada
itresr	itres research
iwbc	iwbc isp services inc.
jlnf	jysk linen n furniture inc
jmgcom	jmg compushoppe
jrml	james river marathon ltd.
kpu-1	kwantlen polytechnic university
ktrans	k-transitions
lakes-9	lakeside digital
learni	learnix ltd.
leisur	leisure electronics
lfpp	the london free press printing
lhi-1	liverton hotels international, inc.
librar	library of parliment
lli-1	login: logiciel interactif
lsuc	the law society of upper canada
lvl-3	lognet
mc-707	start communications
mcsl-12	mbc computer solutions ltd.
mdaes	ministere des approvisionnements et services
mee	ministry of environment and energy
messa-2	messaging architects
minac	minacs inc
mippsi-3	mipps inc.
mit-58	mdf commerce inc.
modate	modatech systems, inc.
mr-437	munich re
multib	start communications
mymdb	minera y metalurgica del boleo
nait	northern alberta institute of technology
ndcc-4	neutral data centers corp.
nlg-1	national leasing group
nsl-261	purple cow internet inc
nybh	north york branson hospital
oagc	office of the auditor general of canada
oaotca	oaot canada inc.
obs-1	online business systems
odllf	office de la langue francaise
okan	okanagan internet junction
oma-19	ontario medical association
omega-9	omegasphere inc.
ontar-60	polymer network
operi	operitel corporation
orcsb	ottawa roman catholic school board
osc-7	options software and consulting inc.
pch	peterborough civic hospital
pcl	purolator inc.
ph-285	pegboard hosting inc.
pilla-5	pillar to post inc.
prepo	zerofail
prgl	prince rupert grain ltd.
qic-26	quarry integrated communications inc.
qis-1	quanta information systems
qsrcon	qsr consulting
radars	radarsat international inc.
randte	rand technologies inc.
rc-55	resources canada
rhd	regina health district
rhpc	r&h pc
ricoh-2	ricoh americas corporation
rma-1	richard a. mcbride and associates, inc.
rmo	regional municipality of ottawa-carleton
rn-29	ru
sanmar-1	sanmar canada
sc-973	savvis communications
sd4mrpm	school district #42 (maple ridge -- pitt meadows)
sddfeis-z	societe d'archivage de fichiers electroniques (safe) inc.
sherid-8	the sheridan college institute of technology and advanced learning
smart-175	smartt inc.
sms-608	sp managed services
soc-23	innovation place
societ-1	societe grics
softim	softimage inc.
softwa-5	softwarehouse (west), inc.
south-229	southern graphic systems, llc
ssim	ssi micro ltd.
st-1516	scarborough toyota
stci	softcom inc.
stgh	st. thomas-elgin general hospital
sunwin-1	sunwing energy
swmc-1	sanctuary woods multimedia corporation.
targe-46	targetguru
107331	1073310 ontario, inc.
ab-1675	andelyn biosciences, inc.
abcc	abc communications ltd.
abn	amb business networking
acrso	atlantic center for remote sensing of oceans
adsn-1	amazon data services nova
agili-6	agilit inc
agprog	agpro grain inc.
aia-9	aciers inoxydables atlas
ail-115	aptitude internet solutions
al-266	datahive.ca
al-3	alibaba.com llc
amazo-4	amazon.com, inc.
anoma	anomaly profiles
ascen-59	smith
attach-2	attachmate corporation
bcaa	bcaa
bcs-108	broadband collaborative solutions
bndp	banque nationale de paris
bradf-12	bradford times
bscnm	blue sky community networks of manitoba inc
bsp-4	buy and sell press
canad-104	canadahost inc.
canon-1	canon usa inc.
cban	canadian business advertising network
cc-3272	cogeco connexion inc
ccaas-1	centennial college of applied arts and sciences
ccl-41	wolters kluwer canadian limited
cdl-1	college de l'assomption
cdlrdl-1	cegep de thetford
cdrv-1	centre de recherche volvox
cdsedsat	commission de sante et de securite au travail
ced-24	ced
ceien	cei engineering associates inc
cenga	cengage learning
centr-60	centrilogic, inc.
cfa	calgary free-net association
cfl-4	canadian fracmaster ltd
cia-55	chatham internet access
cida	canadian international development agency
civeci	civec inc.
cl-1379	continent 8 llc
cmc-33-z	canadian museum of civilization
cmhr	canadian museum for human rights
cn-76	communication nunetworx inc.
cnmc-4	cat 'n mouse computers
cobou-1	cobourg networks inc.
cre-35	cbre, inc.
cscdno	conseil scolaire catholique du nouvel ontario
csl-110	commission scolaire de l'estuaire
csp-56	commission scolaire des patriotes
ctpay-1	ct-payments inc
cudm	communaute urbaine de montreal
cwctc	city west cable & telephone corp.
datasp	dataspace insight inc.
dcs-38	drb computer services
dehavi	de havilland inc.
deltac-5	delta controls
dhfs	dnd halifax fleet school
dih-3	developpement innovations haut-richelieu
ecpl-2	essex county library
eic-3	exchangenet internet corporation
epi	emgee products international
erende	erendezvous corporation
erinc	erin connects
esent-1	esentire
ess-8	timothy tyhurst
fcc-211	frontier communications corporation
ffml-3	floradale feed mill limited
finnin	finning international inc.
flextr-z	flextronics international usa , inc.
fortun	fortune consulting incorporated
fpinn	fpinnovations
geomat	geomatics international
gjcl	gary jonas computing ltd.
gl-460	gmchosting llc
glc-48	genesys laboratories canada, inc.
halhin	halhinet
hdh	hotel dieu hospital
hdw	holden day wilson
helico-1	helicon systems inc.
helixo	helix online inc.
hhpcc-1-z	hpc high performance computing centre
himsl	husky injection molding systems limited
hl-187	hotservers llc
hl-63	horizon linux
hmsl-1	harris media systems ltd.
hnc-11	hubsmart networks corp.
honeyw-7	honeywell limited
hronli	hr on-line
hydroq	hydro-quebec international
icarii	icari inc.
ics-11	info-lynk consulting services
idt-26	international discount telecommunications inc.
idteddq	institut de tourisme et d'hotellerie du quebec
ilinkc	ilink communications
impact-1	impact 3000 inc.
infoed	infoedge inc.
innova-11	innovatron
inter-250	interface
intern-7	internet consultants
intern-94	internauts inc.
interp-5	interpath
irb	immigration & refugee board
irvin-15	irving oil company
itera-1	iterativo
jeuc	just energy (u.s.) corp.
jsd	jonoke software development inc.
kalama-2	kalamazoo resa
kingdo	kingdominion inc.
km-69	kix media inc
lcc-25	la cite collegiale
lcsc-2	left coast systems corp.
lhmg-3	larry h miller group
linx-1	linx
lmpp	lawson mardon packaging pacific
ln-105	liberated networks inc
lsrs-1	lord selkirk school division
lsuc-1	the law society of upper canada
macl-5	airenet internet solutions
madhou	mad house inc.
manito	manitoba government
mcc-32	mccullough computer consulting
mcd-3	mindemoya computing and design
mdl-4	ministere de l'agriculture, des pecheries et de l'alimentation du quebec
mediso-6	medisolution inc.
megtoo	meg@toon station
metrop-63	metropolitan telecomm
mfq	ministry of finances of quebec
mil-51	monarch industries limited
ml-1153	mity lite
mnc-381	mitel networks corporation
mo-293	md online
morewa	morewave communication inc.
mot-22	mighty oak technology
mpb-23	montgomery purdue blankenhip a
mt-226	mazagan telecom
mtgcom	mtg communications
mu	mcmaster university
navtec	navtech systems support inc.
nextd	next dimension inc
niit-2	nrc institute for information technology
northw-13	northwest digital
nserc	natural sciences and engineering research council of canada
nsi	netaccess systems inc
nt-30	nivsu technologies
nwcrf	national wireless communications research found.
oct-16	off campus telecommunications
ol-372	netminders server hosting
onl-2	orcca networks ltd
onl-24	onestream networks llc
orthoc	orthocom, inc.
osf-1	office of the superintendent of financial
osfic	office of the superintendent of financial institutions canada
ouac	open universal and acom computing inc.
path	pathway communications
pccf	planet communications & computing facility
phcs-5	pc helpline computer support inc.
priva-5	private residence
pss-1	phoenix systems synetics inc.
qcc-27	quadro communications co-operative inc
quagga	quagga inc.
quebe-61	solutions sans fil wime inc
quez	questzone.net, inc.
radian-1	radiant communications
rahrm	rahr malting
rc-1476	roots corporation
rcc-5	radio college of canada
rci-4	rco consultants/communications inter-acces
rcrsb	renfrew county r.c.s. school board
rcsnet	rcs netherwood
rigst	rigstar communications inc.
rlq	regroupement loisir quebec
rsrc-1	realcase software research corporation
rt-64	rubin thompson
rtoent	rto enterprises inc.
sailt-1	sailthru, inc.
sait	southern alberta institute of technology
sciil	skeena cellulose inc./repap intl. lumber inc.
sph-1	st. peter's hospital
src-2	stentor resource centre
sss-17	shakeel softwar systems
stand-71	standard connections ltd
stsns	sea to sky network solutions inc.
tbe	teledyne brown engineering
tcl-173	tata communications ltd
tctv	transactiv inc
teksav	teksavvy solutions, inc.
telen-15	telenet informatique inc.
tenebr	tenebris technologies inc.
tghs	triple g healthcare systems inc.
thewes-1-z	westlake chemical corporation
tml-193	taylor mccaffrey llp
townof-5	town of geraldton
toycom	toy com
trans-629	transcontinental inc.
trico-49	tri-county communications cooperative, inc.
ucfv	university college of the fraser valley
ucl-2	ugc consulting ltd.
udqt	universite du quebec a trois-rivieres
uds-10	universite de sherbrooke
univer-232	university of lethbridge
univer-36	university of toronto
usconn-1	usconnect toronto
usgc-2	the ultimate software group, of canada inc.
utl-1	unibase telecom limited
vfpa	port metro vancouver
vodaco	vodacom technologies inc
vsu-16	velocix solutions usa inc.
warlig	warlight industries inc.
wms-3	waterloo maple software inc.
ws-118	windward software inc.
xh-15	xpresservers hosting
xt-9	xpert technologies, inc.
scl-80-z	syncrude canada limited
secure-4	secure networks, inc.
shawc-1	shaw communications inc.
silc-11	secure internet llc ca
sis-7	securenet information services inc.
sl-944	sysomos l.p.
snc-5	skeena net corporation
snclav	snc-lavalin, inc.
spc-10	service provider corporation
srfax	srfax
stage-14	stage2data inc.
stin	storm internet services
stipm	spi technologies, inc., paranaque mm
tc-64	tata communications
tcc-164	tata communications canada
tccl-18	tuckersmith communications co-operative limited
tdtec	tdtech solutions
techn-130	technology advanced services inc
techno-37	technologies sepia inc
teled-5	teledistribution amos inc.
terago-1	teragoptp networks
theco-80	the cont. legal edu soc of bc
tms-4	tts meridian systems inc.
tms-5	tts meridian systems
toront-1	toronto free-net inc.
tpl-5	toronto public libraries
tps-1	total pricing systems inc.
trinet-4	trinetcom-1
trini-72	trinitytech inc
ttis-4	take-two interactive software, inc.
ubisof-2	ubisoft entertainment
unb-2	university of new brunswick
us-399	universite sainte-anne
vac-5	virtual applications corp
valiqu	valiquet lamothe inc.
vcg-8	verizon/gteld/horry county government
versus	versus technologies inc.
versus-3	versus
vg-303-z	ville de gatineau
vl-421	videotron ltee
vrtl	ntt global networks incorporated
vserve-1	vservers
wal-24	westjet airlines limited
wc-908	waycom
wccc-1	west canada clearing corperation
webspi-3	webspin 2000
websta-6	webstation.com
wfc-41	white falcon communications
wideco	widecom group inc
wiel	westburne industrial enterprises ltd.
wmh-1	wilson memorial hospital
wwt-1	wwt
xbrcom	xbr communications
xwork	xworks geoservices inc
yiecl	yycix
yrp	york regional police
tatac-41	tata communications,ltd.
tca-51	tata communications (america) inc
techn-65	technoservices inc.
teledi-1	tele-direct publications
th-14	tier1 hosting
thepor	the portage group
tps-34	topcon positioning systems
trail-7	columbia networks inc.
treef-2	treefrog inc.
trocan	trocana resources
ts-1299	strigo
tsl-18	terra surveys limited
ubity	ubity
ubsag	ubs ag
unicat	unicate networks inc.
univer-243	universite bishop
vcu-3	vancouver city savings credit union
vet-17	very eager 4 tees
vianet	vianet
vl-56	varsteel ltd.
waste-19	waste connections inc.
westm-3	west motor co
whitec-1	white communications
wifir-1	wifirush
winds-39	windsor-essex catholic district school board
winken	w-ink enterprises
wolfpa-1	wolfpaw data centres inc
wos-1	web option snc
wrdsb	waterloo region district school board
sport-40	sportsmans web
spsl-8	sggg portfolio system company ltd.
ssl-219	scansafe services llc
ssmbe	algoma district school board
starbr-2	starbright foundation
stikem	stikeman-elliot
stsidm	service telematique service internet de montreal
synchr-14	synchrolith
synte-4	cloudops inc.
tagnl	technology assurance group - national, llc
tantal	tantalus technologies inc.
tbrhp	thunder bay regional hospital - port
techno-86	technologies 20-20 inc.
telca-1	telcan inc
televo-1	televoice communication
telip	teliphone inc.
thewi-3	the wire inc.
tiw-4	wajam
tns	thoughtport networking svcs
to-71	think on inc
trave-1	travelclick inc.
tsbint	tsb international inc
ttmmrc	tmr telecommunications management & marketing research centre inc.
uhn-4	university health network
unbc-2	university of northern british columbia
unigic	unigiciel
unive-208	sharcnet
univer-80	university of ottawa
uunort-1	uunorth international inc.
vcs-30	viridae clinical services
ventu-38	venture computers of canada
ville-1	ville de quebec
vmo-1	virgin mobile ontario
vr-arin	various registries (maintained by arin)
vttc-z	viktor t. toth consulting
waveb	wave broadband
wcsl-2	west-net consulting services ltd.
wgat	worldgate inc.
wn-31	webx networks
wsc-96	wimmer solutions corp
104873	1048734 ontario inc.
accs9	alberta communication cable services inc
acl-11	amulet consulting ltd.
ai-335	aequitas innovations inc.
ai-63	a.r.c. informatique inc.
ampsl	arndt motor & pump service ltd
ang	alberta natural gas
arg-2	angus reid group
arren	alberta regional research and educational network
as-886	achievers
at-2	amanah tech inc.
at-664	akamai technologies
aus	anarchia underground society
azcza	agence zone communications (zone agency)
beauti-1	beautiful  dreams
bella-21	bell aliant / dsl-hsi
bellat-4	bellatrix systems corp.
bn-361	brainstorm network inc
brd	bkm research & development inc.
bsl-306	blazing seo, llc
bul-14	auracom interhop
cailsy	cail systems
canad-105	cloud at cost
cbc-8	crowntek business centres
cci-106	commport communications international inc.
ccl-9	conoco canada limited
cdadq	centre d'insemincation artificielle du quebec inc.
cdl-8	college de limoilou
cdridq-1	centre de recherche ind. du quebec
cep-33	catch engineering partnership
cfil	crestbrook forest industries ltd.
cityof-157	city of yellowknife
click-41	clickback, inc.
cs-397	connectionet solutions
csgl-137	centurytel service group, llc
dcf-7	dodge & cox
dcs-72	dw collyer and sons
desl-1	domain escrow services limited
devico	devicom inc.
distri-47	distributel communications ltd.
dlnsl	dream lab network solutions llc
doubl-31	double f & company ltd. (o/a ab north)
dyadsy	dyad systems inc.
ecl-95	eseelynx communications ltd.
emg	engineered mediums group
equinix	equinix, inc.
erc-4	elecomm research corporation
esl	enterprise solutions, ltd.
espac	espacenet inc.
etc-1	eta technologies corporation
exadle	exadler technologies inc.
fdcse	fdcservers.net
ffc-1	foothills forest corporation
fidal-1	fidalia networks inc.
fn-181	frontier networks inc
fobsk-1	f.o.b. sky inc.
foncl	fonolo
forti-17	fortisalberta
fw	flowfinity wireless inc
gaiag	groupe accra inc. accra group inc.
gcsl	golden capital securities ltd.
gdvnbb	global digital voice network by blackcomm
grafne	grafnetix systems inc.
group-27	groupe produlith
gsh-3	gowling, strathy, and henderson
gt-346	gallup trucking
gt-515	granite telecommunications
gtekco	g-tek consulting
gwcc	golden west computers canada inc.
gyrdn3	grande yellowhead regional division no. 35
h4yte	h4y technologies llc
hhcp	hamilton-wentworth home care program
hometo-1	hometown
hopew	hopewell logistics
hrii	hydro-quebec research institute (ireq)
hypers-1	hyper sound
icomos	icomos canada inc
icotec-1	icotech
ies-4	inch, easterbrook & shaker
ifias	international federation of institutes for advance study
iisyss	iisys software
indig-3	indigiinet
infost	infostorm technologies
innerw	innerworth
inters-7	intersurf
isc-156	internet security - canada
island-5	island telephone company
it-30	interplex
jac-2	jb audio centre inc.
kendal	kendall systems
kfg-6	keybase financial group
kgcc	kodak gcg canada
kwc11	kore wireless
lcl-9	lilydale co-operative limited
ldm	lomas data management inc.
ldp-18	logix data products inc.
linklo-1	link logistics inc.
lle	the louisiana land & exploration company
llp-1	les logiciels polysoft inc.
logist-3	logistec inc.
lowesc	lowe's companies, inc.
lssb	tbcdsb
mdms	moore data management services
mdslab	mds laboratories
measur	measurex devron inc.
mee-18	moxies - eatz enterprises
micfo-6	micfo-us
mmdcan	mmd canada
mms-1	music manufacturing services
msvu	mount saint vincent university
mt-450	market track
mwc-3	mobius web corp.
nchs	northview centre high school
netmar	netmart inc.
networ-20	networks
nexuc	nexucom
nhlpa	national hockey league players association
nl-69	next layer
nlfp	northern lights fitness products inc
norqu-1	norquest college
nrgm	network resource group of manitoba inc.
nscc-12	nova scotia community college
nsml-2	new seasons market llc
nstn-1	nova scotia technology network inc.
numeri-2	numeric quest inc
oas-9	ocas application services inc.
oes-15	onx enterprise solutions inc.
oicl-2	orbis investments (canada) limited
ondeck	ondeck systems inc.
pairo-1	pairowoodies publishing
pal-35	pal aerospace ltd
pec-3	parkview education centre
penin-13	peninsula group
per1	aptum technologies
polyco-5	polycom, inc.
positr	positron industries inc.
ppp-8	paprican pulp and paper
psc-46	panther software corp.
ptstu	pt studio inc
pw-19	pushware wireless inc
pwt-10	pacific western transportation
qdsl	qwest communications
ql-9	qualtrics llc
qn-21	quantil networks inc
quanta	quanta computer inc.
rdo	regie desinstallions olympiques
risq-2	risq
risqr-2	reseau d'informations scientifiques du quebec
sc-1239	sap canada, inc.
sc-1577	sap canada inc.
sdn2-z	school district no. 23 (central okanagan)
secl-4	s&c electric canada ltd.
sgc-4	solicitor general canada
sgh	scarborough grace hospital
sine-1	service internet ntic enrg.
smh-9	st. michael's hospital
smus-1	st. michaels university school
sn-74	strasmore, inc.
speed-62	speedyrails
sport-51	sportsdirect inc.
squar-22	squarit limited
srd	speedware research & development inc.
ssa-110	structured system administration inc.
ssg-66	scenic solutions / gatewest
syncc	sync.com inc.
syncne	syncnet communications inc.
tc-352	trios corporation
teleun	tele-universite
telme	telmetrics inc.
terrap-1	terraport online inc.
tg-58	terago gta
tgn-1	t. grand networks inc.
tgrc	t grace computer consulting ltd.
theoss	theos software
treb-3	toronto real estate board
trikes-1	trike systems inc.
tsl-8	teledisc systems ltd.
umsu	ultimate multimedia solutions (ums) inc.
vccl-3	vincent communications & controls ltd.
viaa	vancouver international airport authority
visibl	visible decisions, inc.
vmi-3	vmi
vn-68	velocity networks inc.
webmed	webmedia inc.
abc-618	allstream business ca
acal	allan crawford associates, ltd.
accel-3	accelerated connections inc.
aci-2	atlantic computer institute
acs-18	access computer systems
acw-1	alcatel can wire
adfser	adf services inc.
aficom	afi communications
afrinic	african network information center
agrifi	agrifinance
akamai	akamai technologies, inc.
al-1177	abc-hosters llc
al-1478	mighty peace wireless
albert-5	alberta supernet inc
alcl-1	ainsworth lumber company ltd.
altal	altalink lp
amtel-1	amtelecom cable inc
anders-18	andersen consulting
ans-130	atlassian network services, inc.
apotex	apotex fermentation inc.
apseaq	alliance pour la sante etudiante au quebec inc.
arc-181	areva resources canada inc
archel-1	archelon inc.
arrc	advanced radiodata research centre
asc-419	arc'teryx equipment
astrap	astra pharma inc.
at-1948	amazon data services hong kong
atl-184	atlantic.net - toronto, llc.
baudr	baudry.com
bbcc-8	brookfield brp canada corp.
bdiq	bell dsl internet quebec
bdlsdq	bureau de la statistique du quebec
beginl	begin lumber
bellc-10	bell canada - agas
bfn-17	blu fibre networks inc.
bmts	bruce telecom
bnc-36	banque nationale du canada
bruce-12-z	bruce power lp
bshl-1	bridge studios
buzanc	buzan consultants
canadi-2	canadian opera company
canari	canarie inc
carlet-1	carleton university
cbie	canadian bureau for international education
ccs-832	corporation of the county of simcoe
cctl-2	compton cable tv ltd.
cdedrp	carrefour d'information et de recherches pour
cdj	college de jonquiere
cds-9	the canadian depository for securities limited
cdsbeo	catholic district school board of eastern ontario
cdv	cegep de victoriaville
cet-1	cp express & transport
cgc-4	canadian grain commission
cgc-85	canaccord genuity inc.
cgg-4	college gerald godin
cgigr-2	cgi inc.
cibc-4	cibc
cityof-1	city of brampton
cityof-17	city of montreal
cityof-89	city of lethbridge
cpc-4	canada ports corporation
crd-2	city of red deer
csdccl	conseil scolaire de district catholique du centre-est de l'ontario
csf-41	c.s. du fleuve-et-des-lacs
ctc-131	lynxnet.ca
ctl-10	computer-mate technologies limited
cucbc	central 1 credit union
cyber-133	cybernet communications ltd
cynica	cynical networks
dcs-33	duha color services
dem-1	deus ex machina
dmm	duncan mclaren marketing
dnic	dod network information center
dre-2	department of national defence
dt-225	8d technologies inc.
dtc-5	desktop training centres
dtc-6	decision technology corp.
dtc-60	digitcom telecommunications canada inc.
dwihn	dwihn
ece-55	ethica channel enablement inc.
edains	eda instruments inc.
email-21	email response solutions, ltd. - colo - front
empiri-1	disus inc.
eplau	ecklers partners ltd. atlantic united
etc-125	extreme technology corporation
fadeh	fadehost
fdlq	fcs development lp (quad)
ficc	federated insurance company of canada
flext-5	flextrade systems, inc.
fs-272	fido solutions inc.
ftc-58	fortinet inc.
galaxy-38	galaxy telecom
gdclsd	general dynamics corporation, land systems division
gmplp	gaz metro plus limited partnership
gqs-z	groupe-info quatre saisons
grandt-3	grand transformers
grl-11	gauss research laboratory, inc.
gta-6	gamma tau associates inc.
haban-3	habangnet
hawkne	hawknet communications
hdc-81	hive data center inc.
hlr-5	hannover life reassurance co
ics-131	idm computer solutions, inc.
iec-61	index environmental corp
iis-3	insanely interactive systems inc.
imc-87	infinite media corp
incap-5	incapsula inc
infoca	infocan management
infolo	infologic systems
interl-78	interlink connectivity inc
intern-31	internet innovations inc
intern-32	internet login
intern-33	internet montreal
inters-69	interspots inc.
ipvis	ipvision
irrdm	inst. re readaptation de montreal
isc-157	internet security - ca
jobil-1	jobillico
jrcint	jrc international inc.
kc-1663	kinwapt
kcsl	kirk computer systems ltd.
keyano	keyano college
kma-1	keith medcalf & associates
kmpf	kumpf drive ltd.
koboi-2	kobo inc
kpl-1	kitchener public library
lasinc	las inc.
linux-105	airvitesse
lpsg	laidlaw passenger services group
lr1	librairie renaud-bray (1981) inc.
lrgn	larg*net
makaer	makaera vir inc.
mal-52	magellan aerospace ltd
mdlc-1	musee de la civilisation
mdmana-1	md management company
mha-39	macdonald harris and associates
micro-7	microtec technologies inc.
microl-19	micro logic
min-2	megaweb internet network inc.
mll-3	med-chem laboratories limited
molex	molex llc
neon-1	north east online network
netcom-5	net-communication
netwo-323	datatility, inc.
nn-151	netrium networks inc.
nn-43	netuity networks inc
notvir	notvirtual networks
nowehs	noweh software
ns-786	net2go solutions
object-11	objectarts inc.
object-6	objectime limited
oerlik	oerlikon aerospace, inc.
opendn-1	open dns
org-15395	netpulse services
p1n	peer 1 network
pcc-1	pucnet computer connections
pes-2	parklands elementary school
placer	placer dome inc.
plo	peleshok law office
prcc-1	powell river chamber of commerce
prote-14	protected.ca inc.
quebe-72	groupe ism
rcl-4	robelle consulting ltd.
rdio-1	regie des installations olympiques
redmm	reseau electronique du montreal metropolitain inc.
rim-27	reseau internet maskoutain
ripe	ripe network coordination centre
riqr	reseau internet quebec (riq)
ris-9	rodeo information services
risqr	reseau interordinateur scientifique quebecois (risq)
rjcl	read jones christoffersen ltd.
roger-9	rogers cable communications inc.
runab	runabove
sal-40	standard aero ltd
sansr	san@sro inc
saska	saskatchewan motor club
saskt-1	sasktel.(resubmission)
saumon	saumon fqsa
scic	saskatchewan crop insurance corporation
scwn	skynet canada wireless network inc.
serve-108	servermania inc.
ses-7	safe engineering services inc.
sgl-3	sensor geophysical ltd.
wlu	wilfrid laurier university
woc-6	worldwide online corp
wse-35	white star email
wwdc	world warehouse & distribution corp
ymcl	yamaha motor canada, ltd.
zap	zap
abul-14	allstream business us, llc
acfas	acfas
acoaha	acoa halifax
aecl-3	atomic energy of canada limited
agq	auditor general of quebec
aisl-1	ansco information systems ltd
al-1720	aware360
algonq-2	algonquin college
allia-44	alliance numerique
alter-20	alterian, inc.
amf-17	autorite des marches financiers
anuer	anuera telecommunications
arc-8	alberta research council
armour	armour transport inc.
atria-2	atria networks lp.
audioo	audio online incorporated
autom-93	automattic, inc
avotu	avotus corporation
bella-19	bell aliant / fibreop
bella-20	bell aliant / isp
bhds	bialik hebrew day school
big-3	buzz image group inc.
biosym	biosym technologies incorporated
bluecr	abc benefits corporation
cable-11	cablelynx
cacb	canadian association of customs brokers
calfr	calfrac well services ltd.
camion	camions inter-anjou
capeto	capetown computing
cardo-2	cardone plus
cartol	cartologix
casal	index exchange inc.
cbn-32	clearwave broadband networks
cc04	charter communications
ccaat-2	confederation college of applied arts & technology
cdd-1	cegep de drummondville
cepph	the centralized equipment pool project, hugh
cfri	child and family research institute
chemt-16	chemtall incorporated
chiov	chiovitti banana co ltd
cis-431	carillon information security inc.
cis-461	3c information solutions inc.
cityof-155	city of mississauga
cityof-70	city of abbotsford
cnsx-1	cnsx
compus-7	compusult limited
conest	the conestoga college institute of technology and advanced learning
consum	consumers gas
cossol	c.o.s. solutions
crrst	crrs-tv
cspe-1	coxall screen printing & engraving
css-8	complete systems solutions
ct-1113	continent 8 technologies
ctc-258	checkpoint travel co-op inc
ctech	c-tech
cwag	cable & wireless antigua and barbuda ltd
cwh-12	canada web hosting
cwh16	clarity web hosting inc.
cybern	cybernetic control incorporated
darcom-1	dar computer inc.
dcaat	durham college of applied arts and technology
dccom-1	dc computers
dcl-3	daiwa (canada) limited
digiru	digi-rule inc.
docker	docker services
dsc-184	digicloud solutions corporation
easter-1	eastern breeders inc.
eb-140	connexio.ca
ebc	elsag bailey canada inc.
ecdc	ecole commerciale du cap
edeni	eden interactive inc
eed-12	edmonton economic development
efg-1	empire life
energy-2	energy exchange inc.
erss	equity retirement savings system
eten-3	end to end networks inc
fastma	fastman
fbi	frisco bay industries
fcs-2	fundy computer services
fdu	fairleigh dickinson university
gazme	energir l.p.
gbc-45	galaxy broadband communications inc.
gdtsof	gdt softworks, inc.
ghl-78	coinflip
golder	golder associates inc.
golfdi	golf direct inc.
groupe-46	groupe arobas
gsbdm	geological survey branch- dept.of mines/energ.
hot-4	hydro one telecom inc.
hs-232	hyperwallet systems inc
hyperc	hypercube inc.
ic-1123	iteratel communications inc.
icl-248	icynet communications ltd
ideosp	ideosphere inc.
idi-15	direct impact solutions
ids-7	icon data systems
iem-1	inrs-energie et materiaux
iff-8	intl fcstone financial inc
imi-10	infoage marketing intl.
in2n	in2net network inc.
insta-26	instant stream
intraw	intrawest corporation
itl-77	infocube technology limited
its-125	international telecom solutions, inc.
jpdqin	jim pazarena d/b qci islands nets
kcdc	kmh cardiology and diagnostic centers
kd-13	kw datacenter
khs	karmax heavy stamping
kooch	koochwave communications
ksl	kurtz & steel limited
lao	legal aid ontario
lavt	lifeline audio video technolog
lc-1185	lynxx networks
lgl	le groupe lgs inc.
lgs-11	lions gate studios
logic-25	logicweb inc.
ls-972	luminet
lvlt	level 3 communications, inc.
makste	maksteel
mal-3	menasco aerospace ltd.
mcs-14	mps computer services
mctl-4	markdale cable t.v.
mdc-34	magi data consulting
min-16	3menatwork integrated networks inc.
mli-25	missing link internet inc.
mml-1	marsh & mclennan ltd.
moneyl-3	moneyline
msd-115	dms
mtl	mpr teltech ltd.
mw-433	meade willis inc
ncs-158	camplink
ndg	neptec design group
ndl-48	nut digital llc
netma-5	net matrix
ngcetdl	neomedia, groupe conseil en technologies de l'informatique
nhss-1	new horizon system solutions
nis-4	neptune internet services
nsl-95	neustyle
nunal	nuna logistics ltd
nyim	new york internet media
ohi	university of ottawa heart institute
oix	online information xchange
ol-375	589413 ontario ltd
ontari-1	ontario hydro
ontari-2	ontario hydro
opt-11	olympic physical therapy
parol	parolink.net
pavli	pavliks.com
pbc	p. bumbulis consulting
pccsj	the power commission of the city of saint john
pcua	ponca city utility authority
pm-45	pavlov media inc
pn-29	peer 1 network inc.
ppla-1	pmg pte. ltd - astute
praxis-1	praxis inc
pris	peace region internet society
psc-12	protocols standards and communication inc.
ptlp	people's tel limited partnership
pubnet	pubnet
pwc-6	private world communications
pwgscg	pwgsc/gtis
qsd	quesnel school district
quebe-62	mcj conseil
rainbo-4	rainbow software company
rcc-185	rogers communications canada inc.
rfcl	refco futures (canada) ltd.
rl-865	ruralwisp
rmp	regional municipality of peel
rmy	the regional municipality of york
rohcg	royal ottawa health care group
saskat	saskatchewan transportation co.
saskne	sask#net
scc-696	sleep country canada
scottp	scott paper company
sdpdcd	palais des congres de montreal
shado	shadowplay.net
sitinc	sit inc.
sncr	suncor inc.
softfo	softfocus inc.
sph-31	sheraton parkway hotels
sprcss	st. paul's roman catholic  separate school division #20
syndes	syndesis, ltd.
syndi-5	frantech solutions
tdml-3	tnc domain management llc
teecom	tee-comm electronics, inc.
tel-158	telecom evolutions, llc
telesa-2	telesat canada
aac-10	agriculture & agri-food canada
abs-115	acpana business systems inc.
ac-5206	accessweb corporation
acad-1	alberta college of art and design
academ-7	academy of learning
aesc	service alberta
akn	advanced knowledge networks
aladdi-1	aladdin's palace
alicc	aetna life insurance company of canada
am-1010	alkeron multimedia inc.
anl-1	atlantic netcom, ltd
arf-1	addiction reserach foundation
atgs	at&t global network services, llc
autom-100	automattic, inc
bbcl-13	benoit cablevision st lawrence
bc-95	bluarc communications inc
bcgc-2	baycrest
beanf-13	beanfield na loopbacks
bga-8	bga
bis-4	brant interprovincial systems, inc.
blazet	blaze telecommunications
brrd	brantford hydro
bw-350	beacon wireless
campbe-2	campbell soup
canad-92	7098693 canada inc.
cande-6	candeal inc.
canwoo	canwood school
cartie	cartier wines
cbc-10	canadian broadcasting corporation
cbe-2	calgary board of education
ccl-482	camp comm ltd.
ccmrel	ccmr electronics
ccsml	calgah computer systems and management ltd
cds-18	cegep de st-felicien
cegepg	cegep granby
cfoc-1	canadian fiber optics corp.
chc-300	2748134 canada inc hypertec centre
chsc-1	continental healthcare systems canada inc.
ci-1334	christie innomed inc.
cismc	cgi information systems and management consulting
cl-1210	cluster logic inc
cla-19	chemex labs alberta inc.
cla-5	canadian lung association
cn-238	cato networks inc
cns-11	canlink network services
cognos	cognos incorporated
compu-98-z	compucom systems
conbri-1	conbrio teamwork, inc.
connec-1	connectivity technology inc.
consul-2	consulan inc.
contac	contact-net
cosis	4141903 canada inc oa storm internet services
crmcs	c. r. mcguffin consulting services
csc-43	carolian systems corp.
csdm	commission scolaire de memphremagog
ctsl-1	clearbrook technical services ltd.
cyanti	cyantic systems
cygnus	cygnus systems
datali-4	data-link systems
dcs-24	dataden computer systems
digit-196	digital internet group
dis-7	datastrada information services
dis-92	dot internet solutions inc.
dowjon-1	dow jones
dsc-33	dkw systems corporation
dsg-3	digital systems group, inc.
dsl-11	deterministic software limited
dwsl-1	dover web services ltd.
dxsm	dxstorm inc.
dynami-2	dynamis systems
eipsrd	elk island public schools regional division #14
esis-5	esis
foveon	foveonics, inc.
ftc-5	fairview technology centre
ftn-9	full throttle networks inc.
gic	grant internet communications div regan-grant corp
global-4	global online inc.
globo	globotech communications
googl-20	google inc
grayc-1	graycon group
gsl-4	gulliver software ltd.
haleyi	haley industries
hdsdm	hopital du sacre-coeur de montreal
hisl	hawk integrated solutions ltd.
hlps	high level public school
hm-636	hammynet
hooper	hooper household
hostt-2	host tornado
hpsl-1	hara partners systems llc
hrtl	huron county board of education
hutte	hutterian broadband network
hwc-49	hearst connect corporation
idrc	international development research centre
iisa	illiqqusivut - inuit spirit of the arctic
imi-4	infoage marketing international
imtcl	iress market technology canada lp
infode	infodesign corporation
ip-185	iron planet.com, inc.
ip-245	internet papineau
irc-5	insight research canada inc.
is-34	incognito software inc.
is2	is2
isc-158	inovatec systems corporation
isn-4	interop show network
ivatio	ivation datasystems inc.
iw-4	ice wireless inc.
joler-3	jolera inc.
kawart	kawarthanet
kis-58	kaslo infonet society
klgrou	kl group inc.
kpmp	knowledge plus multimedia publishing
krfscl-1	kaufman rossin fund services (cayman), ltd
kubra	kubra inc.
laru	laurentian university
lcc-10	lethbridge community college
lei	informatique inpro
logie	logient
macro-11	macroavenue.com
mayst-1	maystreet
mc-123	start communications
mcc-6	mgv computer consulting inc.
mccart	mccarthy tetrault
mcs-24	multimail communications software inc.
mctl-7	midwest cable
mctrf	manitoba cancer treatment and research foundation
mdamgdq	ministere des affaires municipales, gouvernement du quebec
medius-1	medius communication inc.
met-2	ministry of education and training
mhttl	mya heat transfer technologies ltd
mimosa	mimosa systems
minds-10	mindsoft inc.
mms-2	multinet media solutions
mphec	maritime provinces higher education commission
mtp	toronto police service
neoc	neocom communications inc.
netcor-1	netcore-ca
nexen	nexen inc.
nextdi	next dimension
nfdbl	normico footwear, division of bata ltd.
nos-10	nerds on site
nspl-2	nova scotia provincial library
nts-3	neteasy technology services company
oc-28	ovh (chi)
ocds-2	ottawa carleton district school board
ody	odynet inc
on-6	ovh (nwk)
outsid	outside music
pcdj	pembina chrysler dodge jeep
pco	privy council office
pcs-17	powerhouse computer supercentre
pctime	pc-time inc.
pek	flexential corp.
pfra	prarie farm rehabilitation administration
point-45	points international
pollut-1	pollution probe
ps-383	pacific servers inc.
pubnix	pubnix, inc.
rcc-193	rogers communications canada inc.
rdc-66	rogers data centres
rli-31	red lily internet
rmwb	regional municipality of wood buffalo
roseme	rose media incorporated
roxbor	roxborough telephone
rt-40	r & d technologies
rws-30	rica web services
scaat	sault college of applied arts & technology
scaat-2	sault college of applied arts and technology
selec-405	selectcom telecom
serve-39	server north
sete	government of saskatchewan
sgns	sungard availability network solutions, inc.
shahar	shaharov consulting
shopp-6	1shoppingcart
sicl-3	south island cable ltd
slug	small lately users group
sofpak	sofpak, inc.
solero	soleros innovations
sos-86	stratos global communications
spl-11	saskatoon public library
ssfcaat	sir sanford fleming college of applied arts & technology
sss-492	securitech systems inc.
aac-4	affinity associates consulting inc.
acd-26	acd/labs
acryl	acrylon plastics
afsc-14	agricultural financial services corporation
ahu-9	astute hosting usa incorporated
aibis	acces internet belin, inc. (ste-justine)
ail-2	afg industries ltee
airgi-1	airg inc
aj-6	ancre des jeunes
al-1113	taiga consulting
aml-2	a.b. microtek ltd
an-392	ascent networks inc
andri	andritz automation ltd.
anl-53	avesta networks llc
ans-3	alcatel network services
apcc	schneider electric it corporation
at-88-z	amazon technologies inc.
attice	attic enterprise
azaut	az automotive
babill	babillard synapse inc.
bcg-1	blakes, cassels and graydon
bcg-16	blakes, cassels & graydon llp
bcowhis	bell canada ontario wireless home internet service
bcs-105	broadband collaborative solutions
bcs-122	broadband collaberative solutions
bcs-37	babinszki consulting services
bei	beacon eye institute
bennet-6	bennett environmental inc.
bgn-5	bcs global networks inc.
bis-21	bunyip information systems, inc.
bis-220	bragin  it solutions
bitmot	bitmotion software inc.
bitmov	bitmovers networks inc
bm-665	bell media inc.
bnt-1	border network technologies inc.
brand-63	brandprotect inc.
btl-2	brookville transport ltd.
bvpcl	big v pharmacies co. limited
bws-18	bravenet web services inc
camlin	camlink inc.
canad-108	waterloo internet exchange
canad-16	canadian freightways
canad-63	3588035 canada inc
carre-6	carrentals llc
cceingn	cengn -centre of excellence in next generation networks
ccs-24	champlain college a st-lambert
cds-13	college de sherbrooke
cgmana	c.g. management
chl	chl
clas	canada loan administration service, inc.
cll	connaught laboratories limited
cloud-73	cloudpbx
clubce	club centra
cn-380	convergia networks inc
cnb-2	crimestoppers new brunswick
cnrl	canadian natural resources limited
codei	code inc.
colleg-22	college ahuntsic
craigi	craig industries, inc.
crl-3	cs resources limited
crocke-6-z	crocker communications
csdd	commission scolaire des draveurs
csl-1	compudyn systems ltd.
cti-4	carriere technical industries
cti-8	compcanada technology integration inc.
ctw-25	town of whitby
dalhou	dalhousie university
dcl-6	biovectra, inc.
ddcc-2	drone delivery canada corp.
decisi-6	decision-plus
digit-203	digitally justified technologies
diis-1	dialed in information services
diver-65	diversified business communication canada
dls-3	discovery learning services
do-13	digitalocean, llc
dos-2	datacom online services, inc.
dts-40	dr tax software
dwl-61	dish wireless l.l.c.
dy4sys	dy4 systems inc.
eecl	eba engineering consultants ltd.
ehl-9	elastic hosts ltd.
eicont-1	eicon technology
eidc-1	epi internet direct of canada
enerso-1	enersource
faximu	faximum software inc.
fctbs	finance canada and treasury board secretariat
fdcse-23	fdcservers.net
flemin-1	sir sandford fleming college of applied arts and technology
foxne-2	foxnet inc.
fundse	fundserv inc.
gafina	ga finance
gbcus	gbc-usa
gc-494	gtt
gcaat-z	georgian college of applied arts & technology
gover-10	gonet
gridw-2	gridwerke corporation
gta-3	gta
gvrd	greater vancouver regional district
hl-682	hotlineservers
hoste-7	hostedincanada
hp-12	host papa, inc.
hsc-11	health sciences center
hytei	hyte inc
ibmcan	ibm canada
icc-6	ingenia communications corporation
icl-3	ibm canada ltd
ics-3	institute for computer studies
icsl-27	interactive computer systems ltd.
ieso	independent electricity system operator
iic-10	i3d internet communication
ipl-2	enbridge pipelines inc.
irisco	irisco inc.
jc-65	jastech computers
jnd	james nicholas decker
joymar	mongeon consulting inc.
kdcic	kingston district community info centre
keyano-1	keyano college
kman-1	kitchener-waterloo municipal area network
lc-317	linamar corporation
lfr-1	long and foster realty
lgvl1	internet estrie
liteco	liteco
livete	live technologies
livin-3	livingston international inc.
lpl-141	level 3 parent, llc
lsbe	lake superior board of education -
lscnms	lone star chapter, national ms society
lsis	learn-ed spektra internet services
lupine	lupine entertainment inc.
mancot	manco technologies
mas-13	micro alternative solutions inc.
mc-3246	the ministry of compute inc.
mcgill	mcgill university
mcmkc	mcmk corp.
mdaetp	musee des arts et traditions populaires
mdbs-1	macleod dixon barristers & solicitors
mediag-1	mediaglobe inc.
mit-16	maritime information technology
mn-306	metro news
modeld	model decisions
mpowe	mpower broadband inc.
mws-12	market web solutions
nat-2	north american trust
nation-2	national trust
netag	netago
netdn-2	netdna
nexust-1	nexus telecom
nmobi	n4 mobile
nndsb	near north district school board
nstto	nova scotia technology transfer office
ntne	ntnet operations ltd.
odhic	ontario dairy herd improvement corporation
ofa	ontario financing authority
ohscio	ontario hydro services company inc. (ohsc)
omnite-3	omnitech corporation
oncl	on call internet services ltd.
ontar-38	clearcable network services
ontar-54	neighbourhood connect
ontar-64	rangtel
pbc-51-z	province of british columbia
pbcl	penguin books canada, ltd
pcdyna	pc dynamics inc.
pcl-11	phillips cables ltd.
pcl-210	peo canada ltd.
pcl-5	pagemart canada ltd.
pds-5	prior data sciences
person-5	personatech ltd.
pfv	prime focus vfx
pgl	programmers guild ltd.
phl	paul's hauling ltd
pics-15	ptgi international carrier services, inc.
pn-53	picanha networks inc.
pnam	panamsat corporation
primel-1	primelite communications inc
prl-1	phil's restaurants ltd.
prosp-15	prospek creation inc.
qsl-7	quartet service ltd.
quadra-3	quadravision communications
queens-1	queensway-carleton hospital
quesy-1	quesys inc.
rcc-280	rogers communications
rea-9	robertson eadie & associates
reseau-1	reseau taktik
tcs	techcom computer systems
tdh-10	town of dryden hospital
tec-75	technology evaluation centers inc.
thebla	the blackburn group
tiesof	tiesoft
tnhl	together networks holding limited
townof-15	town of nipigon
townse-1	townsend consulting
trc-84	think research corporation
trs-1	trimax retail systems inc.
trupa	trupanion
tsnl	toronto star
twl-100	tnc wireless limited
ubc	university of british columbia
univer-266	university of regina
univer-312	university of waterloo
vantre	vantree systems inc.
vcrl	vernon computer rentals and leasing
versa-19	versalt inc
wired-21	wiredisp inc.
wis-132	whitewater internet solutions inc
wrl	waterloo regional library
yorkun	york university
zymos	zymos
stc-2	steve temcheff (cosultant)
stcn	stargate connections inc.
stora-14	storagepipe solutions inc.
sulzer	sulzer canada
sw9ol	supreme wireless (979021 ontario ltd.)
tatac-39	tata communications
tbpl	thunder bay public library
tcel	telnet canada enterprises, ltd.
tctlt	tct ltd.
tecomp	t.e. computing incorporated
telec-27	telecommunications xittel inc.
telec-91	telecept inc.
theviv	the vivid group
thinkn-1	thinknet inc.
tns-74	tenable, inc.
topcom	top computer inc.
trl-24	teck resources limited
trl-4	town of red lake
tsg-3	tcn systems group
tsl-6	town of sioux lookout
tssl-29	total server solutions llc
tubeec-1	tube.e communications inc.
tx-1	telecommunications xittel inc.
ucc-13	upper canada college
udqm	universite du quebec a montreal
ulixin	ulix inc.
unbc-1	university of northern british columbia
urs-37	universal research solutions
usnt	us net incorporated
vegate	vega technologies
veriz-418	verizon/gteld/city of
vmcco	vmc consulting
vsoft-2	vsoft inc.
waveph	wavephore canada inc.
wbe	windsor board of education
wdf-1	waterloo data fortress inc
websa-4	websavers
weld	weldwood of canada limited
wfp-3	winnipeg free press
wilson-3	wilson king and company
winpak	winpak ltd.
worldl-23	world-link communications, inc.
wtp	whiteshell technology park
wyzdo	wyzdom technologies inc.
ypg-3	yellow pages group
sht-17	snorkel hot tubs inc.
sl-586	symbotic
smp-2	seeburn metal products
sn-480	24/7 systems and networks inc.
snl-8	sentris network llc
sosk	skyway west
spinna	spinnaker systems
srd-9	sasktel - research & development
ssc-22	sierra systems consultants, inc.
stc-9	speedy transport and cartage
stf-2	sask. teachers' federation
stm-25	summit-tech multimedia communications, inc.
sunli-1-z	sunlife assurance company of canada
talism-3	talisman energy inc.
tc-371	tata communications
tec-78	technology evaluation centers inc.
telost	telostic corporation
tfeind	tfe industries inc.
thelan	the landoctor inc.
thequa-1	the quality center
therub	the rubicon group
thinka-1	thinkage ltd.
toltec	toltec systems, inc.
transp-3	transport canada
trinit-3	trinity college
tsl-350	taozen services llc
twinv	twin valley communications inc
ucnin-280	incontact inc.
udq-2	universite du quebec
ufacl	united farmers  of alberta cooperative ltd
umg-3	universal music group inc.
uptel	uptele inc.
urban-15	urban networks inc.
ure	ubc research enterprises inc.
veneri	veneris
vie-6	vanix
vif	vif internet
vnl-68	bisecthosting
wdjs	westeel, a div of jannock steel
weste-255	westech
wman	westman communications group
xtrane	xtranet communications
yellow	yellownet
yourl-3	bc cable
youst-2	4youstart
zaftaf	zaftaffen software
3menwo	3men@work
3web	3web media communications inc.
abisko	abisko manufacturing
ac-3502	alimentation couche-tard, inc.
acl-5	andyne computing ltd
ad-62	amc direct inc.
agt-1	alberta government telephones
ais-195	a-web internet services
alber-63	alberta roadbuild.& heavy cons
aliant	bell aliant regional communications, inc.
aliasr	alias research inc.
altcsy	alt-c systems inc.
an	arima networks inc.
aru	astra research unit
as-318	acceo solutions inc.
asigr	asigra inc
asser	assertivenet
atcl-2	auto-trol technology (canada) ltd.
aurc	aurora communications exchange
aw-59	airnet wireless inc.
bbl-152	bond brand loyalty inc.
bcgma	british columbia government managers association
bclc-1	british columbia lottery corp
bdsb	bluewater district school board
beg-7	b2b ecs global
bitl	bayview international trucks ltd
bm-1365	bell mobility inc.
boisec	boise cascade
bombar-1	bombardier inc
bruye-z	bruyere continuing care inc.
bsp	butterfly signal processing inc.
btm	brownlow, thompson & mckay
capila-z	capilano university
cc-4418	canfibe
ccdmd	ccdmd
ccl-134	ceridian canada ltd.
cclind	ccl industries inc.
ccs-439	caledon card services
ccs-512	supreme servers
cdb-4	cegep de baie-comeau
cdl-7	combustion dynamics ltd.
cdnet	cdnetworks inc.
cdridm	centre de recherche informatique de montreal
cerf	cerfnet
cf-1413	city of fredericton
cgp	the city of grande prairie
cis-16	compulink internet solutions
cis-6	creative information solutions
cnypr	city of north york parks and recreation
comput-30	computer advocacy, inc.
comput-97	computer bay
connec-14	connectalk inc.
consul-1	consultronics limited
conti-94	cavern technologies
corpor-2	corporate computers inc
cresce-4	crescent school
csp-75	commission scolaire de portneuf
cst-45	clemmer steelcraft technology inc.
ct-960	carrytel
ctl-3	calian technology ltd.
dataps	datap systems
dc-1513	decathlon canada inc.
dcc-9	duncan computer centre
dolfes	dolfe systems
dpmme	dpm media, inc.
eboard	eboard inc.
ecol	echo online internet inc.
ecomme	e-commerce inc.
eisc	eidos information spaces corp.
emc-55	exxon mobil corporation
eonix	eonix corporation
esl-290	ecolink
eten-7	end to end networks inc
etsnet	ets.net inc.
farenh	farenheit films
fcl-6	flakeboard company ltd.
fgil-1	fort garry industries ltd
fh-228	pinkbike.com
fiber-84	fiberspeed
fnisc	fnis canada
fpf	fredericton police force
frco-1	free range cloud oslo
fujits-11-z	fujitsu america inc.
g3tel	g3 telecom corp.
gbcaat-z	the george brown college of applied arts and technology
glmdje	the gamemaster / le maitre de jeu (enr.)
gnw	gt net works inc.
goodma-1	goodman communications inc.
gwt-34	global wireless telecom inc
hbn-2	hutterian broadband network inc
icesl	international comptech engineering services, ltd.
idahol	idaho lottery
ifpl-z	international forest products ltd.
iis-23	imn internet services
il-845	ipxo llc
imagen	imagen communications inc.
in-27	it7 networks inc
inc-7	inc.
innova-67	innovative decisions, inc.
ios-1	institute of ocean sciences
ismc	information systems management corporation
itcl	island telephone company ltd.
jdcca	jdc.ca inc.
jerrwo	jerrwood
jucht-1	juch-tech usa, inc.
kcl-4	k.t.k/ communications ltd.
kea-10	kuhl airnet, inc
ktc-5	karr tuttle campbell
lakela	lakeland college
lavan-3	lavanet
legasy	legasys corporation
linam	linamar corporation
liqui-26	liquidnet ltd.
lis	legislative assembly of ontario
london-22	london hydro
ls-460	lightening systems
lumber-1	lumber co.
lvscu	long view systems corporation (usa)
mc-688	start communications
mcs-16	mega computer services
mdaidq	ministere des affaires internationales du quebec
mfc-15	mackenzie financial corporation
micron-29	micronpc
microp-3	micropoint development inc.
microt-2	microtek corporation
minolt	minolta canada inc.
mis-319	mahost internet services inc.
mnc-14	march networks corporation
mozil-1	mozilla corporation
mpd-3	medical plastic devices inc.
mrmsd4	maple ridge-pitt meadows school district # 42
munroe	munro engineering inc.
nbchs	north battleford comprehensive high school
netwel	netwell communications inc.
nexeo-2	nexeon technologies, inc.
nipiss	nipissing university
noneye	none (yet)
northe-12	northernnet of canada
nserc-1	national sciences and engineering research council
obviou	obvious systems inc.
ocad-1	ontario college of art & design university
octrf-1	ontario cancer treatment and research foundation
ol-1	osolabs llc
ol-146	2054235 alberta ltd
online-10	online corporation
ontar-49	lime telenet
ontar-53	envi networks ltd.
org-11916	1191658 ontario inc
otc-68	open text corporation
oyp-1	o & y properties inc.
pathw-21	pathway communication
pcs-45	professional communication services inc.
pdsb-2	peel district school board
pea	paquette et associes
pip	partners in performance
pis-73	pacific internetworking solutions
planon	planon telexpertise, inc.
plext-2	plextec inc
poct	priority one computer training incorporated
pqtl	pico quantitative trading, llc
psc-41	pfw systems corporation
psms-2	psms
qgcl	quinte geophysics & consulting ltd.
quebe-78	netlinux
quest-19	questrade inc
rainfo	rainforest software inc
rc-401	redbird communications inc
rcc-191	rogers communications canada inc.
rcl-1	realtime consulting ltd.
rdc-71	rogers data centres
relia-74	reliable-isp
rmp-3	roy-babin multimedia production
sbghrc	st. boniface genera hospital research centre
schd	south central health district
scs-13	softek
sdi	siv data international inc.
sequoi-6	sequoia institute
seven-6	sevenl networks
sfs-1	scott's food services
sh-282	stack harbor inc.
sie-11	saskatoon internet exchange inc
spn-1	starbright pediatric network
ssc-364	seventh street consulting inc.
sterl-89	sterling infosystems, inc.
stinet	sti-net inc.
stl-172	strong technology, llc.
tds-83	trilogy dominicana, s.a.
telequ-1	tele-quebec
telma-9	telmax inc.
terran	terranet technologies inc.
thegra	the grain insurance company
thinka	thinkage ltd.
threew	threewave software
tis-113	tap internet services inc.
toyot-26	toyo tire canada ltd
tpl-7	toronto public library board
tplob	tendering publications limited o/a bids
trentu	trent university
trgo	terago networks inc.
tsi-1	txn solution integrators
tsl-1	teleride sage ltd.
udqc	universite du quebec a chicoutimi
uppl-2	unipac packaging products ltd
vansco	vansco electronics
viagen	viagenie inc.
vn-54	voi net inc.
vodal	vodalink telecom inc.
vsdv	videotron systemes d'information (vsi)
vts-1	v.p. teleconnect services inc.
wasser-1	wasserman stotland
waves-3	wavesat
wcp-20	weatherford canada partnership
weblin	weblink
webnet-1	webnet inc.
westwo-12	westworld computers
wfcc-10	western fibre communications corp.
wis-7	westlock internet solutions
wwu	western washington university
ycs-1	yamatech connectivity solutions
ys-2	yp solutions inc
ysal	mezzemi
zayob	zayo bandwidth
tertiu	tertius technologie inc.
tf-178	ting fiber inc.
theaur-1	the aurora project
thecan	canada council for the arts
thepri-9	the printing house
therod	the rodents' nest
tis-8	taxprep information systems
townof-3	town of dryden
tpl-210	transcanada pipelines limited
tss-217	total server solutions
ttmt	tlc tech
tymeou	tymeout bbs
utc-19	u&n trade corporation
uuserv	uuserve&
vvdc-1	vdc virtual data corp.
wcrcssb	welland county roman catholic separate school board
web201-5	web2010
webnet-7	webnet
wireds-1	wired solutions
wis-102	wisp internet services inc.
wkrt	west kentucky rural telephone cooperative corporation, inc.
wl-242	windscribe
xtl-4	xydom technologies ltd.
yukonc	yukon university
aam	access advertising management inc.
ablcan	abl canada inc.
ach-2	atlantic connect (halifax) inc.
acl-20	abelsoft inc.
acs-14	adlan computer services
acs-27	allen computer services co.
acsc-3	a+b computer systems corp.
adsil-1	amazon data services ireland limited
advan-123	advantagedotcom services inc.
aeii	aei internet inc.
ag-409	avmax group
agt	agt limited.
ai-425	astral internet inc.
archit-1	architech microsystems, inc.
aru-1	astra reserach unit
ats	avec technical services
auc-2	algoma university college
avc-1	bow valley college
bc-72	backland communications inc.
bdlsdq-1	bureau de la statistique du quebec
besdnno-z	the board of education of school district no. 83 (north okanagan-shuswap)
bgpp	shaw telecom g.p.
bl-216	braveway llc
bm-1363	bell mobility inc.
bs-379	brock solutions inc
bsc-73	best software canada
bss-8	bishop strachan school
c1ci	trutel inc.
cai1	centennial academy inc (1975)
cal	canadian astronautics, ltd.
canad-111	12128489 canada inc.
canad-48	4544188 canada inc.
canad-67	linknet telecommunications inc.
capita-4	capital works, inc.
caris-3	caris
cas-1	cimtek automation systems inc.
cbs-102	canadian blood services
ccbi-1	cbi computer & business integrators
ccin	cci networks
ccohs	canadian centre for occupational health and safety
ccw-1	the corporation of the city of waterloo
cdrlt	centre de recherche licef (t=e9l=e9-universit=e9)
cedrom	cedrom-sni inc.
cgoc	cogeco communications inc.
ch-1192	cold heading company
cirru-3	cirrus9 inc.
citegl	citeglobe
cityof-31	city of modesto
cmgl	carlson marketing group ltd.
codez-1	codezone inc.
commun-173	communique kaleidoscope
confed-1	confederation college
cpdc-1	concord pacific developments corp.
crt-3	canadian radio-television and telecommunications
csdt	commission scolaire du chemin-du-roy
ctfn-1	chippewa of the thames first nation
ctr	carlton trail reda
ctsl-52	cbts technology solutions llc
cudl	communaute urbaine de l'outaouais
cupe	canadian union of public employees
cyberp-1	cyberpages inc.
datape	data perceptions inc.
dateln	datelnet, inc.
datori	dator inc.
dice	dreamscape interactive computer entertainment
digit-264	digitelwebs inc
diia	deer island internet association
dn-151	driftwood networks inc
doncar	doncar systems, inc.
drps	durham regional police service
dsl-4	dataphile software ltd.
dst-45	digital shape technologies inc.
dtmdbd	dtm systems corporation
eagle-11	eagle.net
earthl-4	earthland consulting
eil	epc industries ltd.
eis-76	epic information solutions
el-48	esolutionsgroup ltd.
elast-5	elastic host
enterp-2	enterprise network inc.
ergl	environics research group limited
ets-2	ecco temporary services
fdc-1	federation des cegeps
fdcl	fbm distillery co. ltd.
fds-3	fonex data systems inc.
fhr-3	fairmont hotels & resorts inc.
fn-23	f12.net inc.
fn-243	fidalia networks inc
fns-28	fsh network services inc
fsl-2	fisher scientific limited
futur-24	future electronique inc
ga-197	go auto
gcg-2	groupe conseil genivar inc.
genesy-2	genesys canada inc
geonex-1	geonex aerodat inc.
gla-3	the great-west life assurance company
global-238	global connexions inc.
govtof-1	govt of manitoba
growm-11	growmark, inc.
hardw-2	hardware strategies inc.
heart-54	heartland livestock services
ht-561	home trust
ic-1425	internap holding llc
ic-261	itci corporation
icbc	insurance corporation of british columbia
icl-30	internet crossroads ltd
ics-20	internet connectivity services inc.
idrdi	institut de recherche d'hydro-quebec (ireq)
il-35	ipxcore, llc
incoli	inco limited
inter-1438	internetbusinesscorp.com
intern-29	internet access inc.
isal-4	immediate sales agency ltd.
iso-18	alberta electric system operator
jkltec	jkl technologies inc.
jne-2	jne
js-116	john st. inc
kman	kitchener-waterloo municipal area network
kmbscl	konica minolta business solutions (canada) ltd
laws	lyttonnet
legala	legal aid
lifel-10	lifelabs medical laboratory services
logica-2	logical systems
loyali	loyalist college
markre	mark resources inc.
mcdona-1	mcdonald's corporation
mctsl	maxim transportation services inc.
mdl-14	ministere de l'environnement
megaw-5	megawire inc.
micro-39	microsystem technology
mim-1	mackerel interactive multimedia
minerv-1	minerva technology inc
mml-3	md management limited
mnp-2	meyers norris penny & co.
mpl-7	merak projects ltd.
musk	muskoka worldlink inc.
mwwl-1	marks work wearhouse ltd
nbc-5	national bank of canada
nc-182	nubirdz / nubirdz computers
netmar-7	netmarc.com
netse-9-z	netsell communications
nkc	northwest kidney centers
nrcc-1	national research council of canada
nsrfc	nova scotia research foundation corporation
oldsco-1	olds college
omnig-3	omniglobe networks inc
ontari	ontario hydro
opcoms	opcom solutions inc.
otsco-1	otscom system integrators inc.
panel-2	panelbox
perrie	perrier software
phintl	phintley enterprises
pihl-2	pennine international holdings limited
power157	powerhouse management, inc.
pvl	paprican, vancouver laboratory
qc-30	qtrade canada inc
quebe-50	ebox
quebe-82	haute-vitesse.com
queens-2	queen's university
rlmq	rimq
rndcan	rnd canada, inc.
sb-727	systemes byzantines inc
scc-730	swivel
sccas	simcoe county children's aid society
sdm	shoppers drug mart
shelty	shelty systems
signat-1	signat
sis2	sis
skyhaw	skyhawke technologies
sl-1100	startech.com ltd.
slga	saskatchewan liquor and gaming authority
smc-22	stephen martin consulting
snsml	sasktel's network services multimedia lab
softwo-2	softwords research
sqdj	societe quebequoise d'information juridique
src-1	stentor resource centre
ssh-22	select sandwich hq
starga-2	stargate communications
stral	strala
supra-3	supra canada technologies ltd
surfe-1	surfeasy inc
sutton-1	sutton realtors
targe-45	targetguru
teldi	teldig systems inc.
theint-1	the internet group
tmpcl	trans mountain pipeline co. ltd.
tordio	tordion consulting inc.
trls-1	thompson-nicola regional district
twtc	tw telecom holdings, inc.
uapinc	uap inc.
udmcds	universite de moncton, campus de shippagan
univer-103-z	university of montreal
vc-405	voipster communications, inc.
vcc-3	visual communications corporation
vcs-4	vega computer systems inc.
vddl	dery telecom inc.
videof-1	video flicks
virtua-14	virtual source
vistar	vistar telecommunications inc.
vtlnr	videotron telecom ltee / numerique / reseau
walmar-z	wal-mart stores, inc.
wpc-3	the wired part of canada
xcerts	xcert software inc.
aaprs-z	alberta amateur packet radio society
absolu	absolu technologies inc.
acsl-1-z	andromeda computer systems ltd.
aircan	air canada
aircan-1	air canada
ais-92	assist information services
alber-102	2227155 alberta inc.
algoma	algoma steel inc
allegr-2	allegro films inc.
anjie	anjiejie.com
apt-144	am pro telecom inc
apw	service alberta
atomi	atomic falls
babill-1	babillard synapse inc.
barre-1	barrett corporation
bc-z	bcnet
bellic	bell ics
bfc-2	by the falls computers
bitbl-1	bitblock.com
bitin-2	bit incorporated
bl-786	blazingseo, llc
bmc-9	bell mobility cellular
bnu-1	bluecat networks (usa) inc.
brl-3	bogomips research labs
bytewi	bytewide marketing
caa-37	the calgary airport authority
cabw-1	canadian auto be web inc.
cac-110	cga association of canada
camh-1	centre for addiction and mental health
canad-62	novel, inc
canad-80	9512128 canada inc.
cb-67	cobalt business
ccaat-1	canadore college of applied arts and technology
ccg-252-z	caa club group
ccidread	cirano (centre interuniversitaire de recherche en analyse des
cde-2	canadian department of education
cdr	college de rosemont
cegeps	cegep de st-felicien
cegeps-2	cegep saint-jean-sur-richelieu
choop-1	the constant company, llc
cic-280	converse in code inc.
cipld	centre international pour le developpement
cl-17	cnservers llc
cm-193	critical mass inc.
cn-35	colony networks inc
cndc	cci networks, a division of corporate
cois-2	central ontario internet services, inc.
comput-13	computerland regina
comput-55	computer advantage
corel-3	corel corporation
cottco	cott corp
crc-10	cable regina co-operative
crc-6	champlain regional college
cscl-1	canadian scale company ltd.
csf-2	the client server factory, inc.
csv-3	commission scholaire verdun
ctc-9	carpenter technology corporation
dbes	dryden board of education - sioux
dcaa-1	durham college of applied arts and
ddec	dream data enterprise corporation
delcan-1	delcan, inc.
depart-13	department of transport
dflora	dflora systems inc.
digic-1	digicom
digita-12	digital paradise inc.
dipixt	dipix tech incorporated
dm-20	data matters inc.
dns-27	dexagon inc.
domini	dominion directory company
domtar-2	domtar inc.
dupre-1	duprey.net
ecrit	ecritel inc
ed-298	elite digital
edhech	hautes etudes commerciales (hec)
egnl-1	egihosting
elcc	express lane communications corporation
ergoso	ergosoft inc.
esecu-4	esecuredata
exlk	execulink telecom inc.
fas	focus automation systems inc.
feldsp	feldspar networks
ff-377	flo form
fpl-135	fisher & phillips, llp
frch-1	free range cloud hosting inc.
fronti-3	frontier software company
gcc-11	gtn communications corp.
gcc-182	gazelle communications corp.
gcl-4	gemtex co. ltd.
gemesy	gemesys ltd.
geron-1-z	geronimo group inc.
gespro	gespro inc.
gilead-1	gilead sciences
goodma-2	goodman and carr
googl	google, llc
gqvl	gwaii communications
grant-2	grantstown inc
grc-12	global relay communications inc.
groupe-21	groupe prometheus inc
gsg-33	global sourcing group
gtane	gtanet networking
gwnsys	gwn systems inc
hcc-29	hookup communications corporation
hdq	hayes dana quebec inc
hfc-3	hostess frito-lay corp.
hfsl	hogg fuel & supply ltd.
hriinf	hri informatics inc.
hs-372	hosting services, inc.
hsa-1	holt software associates, inc.
hsi-1	hartlepool systems international inc.
hurn	huron telecommunications cooperative limited
icl-4	idec canada ltd.
icl-6	ica computer ltd.
id-4	icube development (calgary) ltd.
idmedi	idmedia
iepf	iepf
ihc-105	i heard corp
iis-42	imn internet services
impact-35	impact blue
inets-2	inetsafe corporation
infote-14	infoteck inc.
innova-7	innovation station
intb	alphanet telecom, inc.
interl-11	interlect
ios-40	inforelay online systems, inc.
iq-2	i.s.f quebec, inc
jcst	jcst
jmd	jkl micro distribution inc.
kc-1863	kupsta consulting inc
klb-2	kaspersky lab b.v.
kmc-5	kubota materials canada corporation
lc-535	limewave communications
lgb	le groupe berclain, inc.
lgb-1	le groupe bdds
lgc-1	le group cgi
lgci	le groupe conseil innovitech
lsz-1	les systems zenon
marshi-1	marsh inc.
mc-62	mckesson canada
mdl-6	microtronix datacom ltd.
media-542	mediamoat inc.
member-1	membertech management inc.
mfnerc	manitoba first nations education resource centre inc.
mhhc-1	manitoba habitat heritage corp
mhil-2	manitoba hydro international ltd
mksinf	mks informatique
mms-24	melchior management systems
msft-z	microsoft corp
msl-139	peaktera
mtc-4	manitoba theatre centre
mttl	mettel
mun-3	memorial university of newfoundland
nano	nechako access network organization
nbde	new brunswick department of education
nestle-2	nestle canada inc
nl-624	alt telecom
nlis-1	northern lights internet solutions
nnet	nunet inc.
nrc-46	nelson river construction
nt-21	paysafe
oac-27-z	omers administration corporation
olsc	ontario library services centre
omerde	omer deserres
ommri	ommri
ontar-9	rural wave
opc-14	omega performance corporation
ormuc	ormuco
osl-57	on-call solutions
person-56	persona communications inc.
pesl-3	precision energy services ltd.
pnb-3	province of new brunswick
pnm-15	pretecs networks inc.
prl-4	proctor & redfern limited
ps-78	pason systems corp
psdpr	psd professional systems/designs, ltd
psl	promacad services ltd.
ptcieb1	primus telecommunications canada inc. -eastern-015- brv 1
ptcieb1-1	primus telecommunications canada inc. -eastern-017- blv 1
qac-2	quest an alliance corporation
qel-5	quadranet enterprises llc
qhost-6	qhoster.com
qlsl	qbyte land services ltd
quebe-57	9217-0182 quebec inc.
rbcca	rbc wealth management
rcc-182	rogers communications canada inc.
rel-51	r629 enterprises ltd
resot	reso-tech inc.
riinc-1	r2i.ca
ridea	rideau inc.
risq	reseau d'informations scientifiques du quebec (risq inc.)
rn-45	rhicom networks inc.
ronai	rona inc.
rsr	reseau sante richelieu-yamaska
ruc-7	redeemer university college
sbs-280	smartlayer business solutions
sbs-320	smartlayer business solutions
scbc	the science council of british columbia
scc-67	sea change corporation
sccaat	st clair college of applied arts and technology
scdsb	simcoe county district school board
scl-18	sigil consulting ltd.
scs-228	stantec consulting services inc.
sct-142	secretariat du conseil du tresor du quebec
sdfnts	first national technology solutions, inc.
secur-177	securedconnectivity.net
sites-1	sitesell inc.
slcent	slc enterprises
sliss	saskatchewan land information systems (slis)
smcdsb-1	simcoe muskoka catholic district school board
smsv	smart servers
sph-33	sheraton parkway hotels
sten	stentor national integrated communications network
steven-3	steven o'reilly
stjre	st&j retail
stora-22	storageasp inc
stsfa	sea to sky freenet association
summit-4	summit physio inc.
sunc-1	strategic unix networks corp.
sush	sunshine communications
tangr-2	tangram canada inc.
tatac	tata communications
tatac-49	tata communications,ltd.
teaml-2	teamliquid
tfi-16	cloudsingularity internet exchange
theban-1	the bank of canada
thebgw	the bgw group inc
thecit-6	the city of moncton
theent-1	the entrepreneurship centre
trblc	trevors r bjurman law corporation
treb-1	toronto real estate board
trigra	trigraph inc
tsi-81	theorem
tss-218	total server solutions
udqq-z	universite du quebec
unite-472	uni-telecom
univer-75	universite laval
vantel	vantel consulting
vc-116	vision critical
vgs-9	colocrossing
viceen	vice entertainment inc.
vivos	vivosweb inc.
wavesp	wavesplitter
wcs-6	wilkor computing services
wcsc	westonia computer systems of canada
westco-5	westcoast energy inc.
wpug	winnipeg pc user group
rlbl-1	r. l. bondy ltd.
rlgc	roche ltee groupe conseil
rn-9	rhyzome networks
rtl-52	ontarioeast.net
rwg-2	rogers west
sabako	sabako inc.
sc-3814	symack
scsl-16	sexqeltkemc cloud services ltd
sdladq	societe de l'assurance automobile du quebec
selkir	selkirk college
seneca-1	seneca college of applied arts and technology
sfu-1	simon fraser university
sg-712	stingray
sgcmc	simpson gilbert chambers marketing communications
sm-1600	get racked
smartw	smartware technologies
snc-62	stormcloud network (canada) incorporated
so-149	sister lakes cable
sp-1262	renegade technologies
spl-23	scott paper limited
ssl-2	sirius solutions, ltd.
st-1491	nthweb
swo-3	solar winds online
tauli-2	taulia inc
tbg-1	tricomp bus group
teksi-1	tekside.io inc
telke	telkel inc.
teloi-3	teloip inc
telose	telos engineering inc
tfi-10	tech futures interactive inc.
thestu-1	the study corporation
thoug-1	thought convergence, inc.
tis-107	trinex internet solutions
tpl-39	transcanada pipelines ltd.
transc-53	transcanada pipeline
tsl-3	tesseract software ltd.
tubeec	tube.e communications inc
u3r	unit 36 research
uccb	cape breton university
uhn-3	university health network
unikt	uniktour
univar-1	univar corp.
uqeo-1	universite du quebec en outaouais
verti-30	vertisoft
vhq	virgin home quebec
vmq	virgin mobile quebec
vphs	virtuall private host services
wcfl	western co-operative fertilizers limited
web	web2010, inc
web201-4	web2010
wgh-2	woodstock general hospital
wizar-3	wizard tower techno services
wlu-3	wilfrid laurier university
wob-1	western ontario breeders, inc.
wolfp-1	wolfpaw services inc.
woodgu-2	wood gundy
worldw-3	worldway holdings inc.
wvc-1	world vision canada
xbrcom-1	xbr communications inc.
yello-27	yellow pages group
zonel-2	zonelight inc
7ol	728928 ontario limited
act-3	advanced cultural technologies inc
adtech	ad technologies inc.
advanc-5	advance electronics
afs-2	aegis financial systems inc.
agctl	advanced gravis computer technology limited
aimc-5	alberta investment management corporation
alent	alentus corporation
allig-3	alligacom inc
amm	alliance mass marketing inc.
aot-1	ad opt technologies inc.
apozro	a.p.ozrout & associates
arin	american registry for internet numbers
asc-18	a-tra shopping centres inc.
asc-28	array systems computing
avenor	avenor inc.
avp-2	atlantic visual presentations
backb-5	backbone technology inc
backla-1	backland communications inc.
banq	banq
barre-3	barrett xplore inc
bc-84	bell canada nhs
bcsc-5	blue coat systems (canada) inc.
bellhs	bell/hse
bil-2	business interactive ltd.
bna-3	bosal north america
boldtn	boldtnet, inc.
border-1	borderline technologies
brambl	brambles canada inc.
branks	branksome hall
btg-10	breken technologies group
canad-1	canada fiber inc.
cbc-432	bell mts data centres g.p.
cbc-5	conference board of canada
cc-2930	calligo (canada) inc.
ccl-81	ceridian canada ltd
ccsc-2	compusolv computer systems corporation
cddtdc	centre desjardins de traitement de cartes inc.
cgi-4	cgi
cil-6	it.canada
cint	can inst for native training
cityof-364	city of calgary
cityof-67	city of fredericton
clc-2	canadian labour congress
cmic-5	computer methods international corp.
cognit-2	cognito
cognol	cognologic software inc.
cpa-55	canadian payments association
cryoca-2	cryocath technologies inc
csa-3	canadian standards association
csd-42	cpu services d'ordinateur
csdc-2	commission scolaire des hauts-cantons
csj	city of saint john
csl-389	coeo solutions, llc
csv-13	commission scolaire vallee-des-tisserands
ct-1366	celerity telecom
ctnl-1	ctv television network limited
cwsl-6	cable & wireless st lucia
dc-568	datadrill communications inc.
dds-81	daemon defense systems inc.
dfo-3	department of fisheries and oceans
dillte	dilltech systems
dis-32	docuweb information services inc.
dlgllt	dlgl ltee
dougla-4-z	douglas college
dsa-1	dan stevens & associates
easym	easymanaged
edts	ecole de technologie superieure
eis-5	e-link internet services
ekcc	college of the rockies
epm-8	electronics project management
epsbdn	edmonton public school board, district no. 7
esl-56	evtech solutions ltd
everex	everex systems, inc.
exper-31	expereo usa, inc.
eyc-1	ernst & young canada
fab-1	forest alliance of bc
faneui-1	faneuil ltd.
fcc-299-z	fujitsu consulting (canada) inc.
fis-295	falcon internet services inc.
fondsf	fonds fcar
fronti-2	frontier collegiate
fsight	fsight2
gancan	gan canada
gcc-293-z	glencore canada corporation
gcc-5	gs/x computing corporation
gdbl-1	generic dot business ltd.
ggbs	goodman & goodman, barristers & solicitors
gml-26	groupe maskatel
gogl	google llc
gqgq-z	gouvernement du quebec (government of quebec)
grayso	grayson consulting
groupe-4	groupe mediom inc.
gtechc	igt global solutions corporation
hanson-1	hanson, hashey
hhl-53	haven hosting ltd.
hkcc	h k computer consultants
holcim	holcim (us), inc.
homeh-3	home hardware stores limited
iad-5	international acadmey of design
ifdscl-1	international financial data services (canada) ltd.
igfs	investors group financial services
ilap	internet light and power inc.
ime-1	internet mont-laurier, enr.
ims-9	inquiry management systems
infoly	infolytica corporation
infra-24	infra-solutions inc.
inkg	wtc communications
innuit-2	innuity, inc.
integr-40	integrand systems
intel-195	intellinet
intell-11	intelligent microsystems
interl-20	interlink inc.
intern-23	internet jrv, inc.
ioteki	iotek inc.
ipokei	ipoke internet inc.
isl-5	infostream services ltd.
ismi	inf. sys. mgt. (ism)
iu-64	intrawest ulc
jbl	j.d. barnes limited
jsic	jade simulations international corporation
kamloo	kamloops freenet
kimsas	kimsa services inc
kineti-2	kinetic records
lcs-6	lakefield college school
lhrc	load, human resources canada
living-6	livingston international
lrtl-5	lansdowne rural telephone company ltd
mediah	mediahouse inc.
medius	medius communications inc.
mgs-2	mackenzie gervais s.e.n.c.
mhc-5	maclean hunter communications inc
mie	m.s. informatique enr.
ml-802	zirro
ml-880	messagingdirect ltd.
monico	monicorp inc.
mpic	manitoba public insurance corp.
mrt-19	may ruben technologies inc
nacin-1	connect it networks
nbcccn	new brunswick community college (nbcc)
ncc-22	netway computer consulting
ncl-6	netinterior computerlinks ltd
nicl-1	network integrated communications ltd.
nmr-2	nielsen marketing research
nps-4	northern parallel software company
nrtl-4	nrtc communications
ntl	northerntel limited partnership
opsia	opsia inc.
optelp	optel p.m.l.
org-34822	3482286 canada inc
ost	open system technology
parady	paradynamics inc.
pcp-11	p.t. cakraperdana proniagatama
pcril	prairie crocus rural internet limited
pdc-37	precision drilling corporation
peel	peel memorial hospital
peinet	peinet inc
pelmo	pelmorex communications
person-6	personatech ltd.
pmt-49	procon mining & tunnelling
pn-31	peer 1 network inc.
prodo-4	prodosec inc
ps-422	pulse servers
qacou	qacourier
qdsc-1	quebec inc. dba servlinks communication
qi-8	quebec internet inc
quebe-56	9219-1568 quebec inc.
rcs-22	royal canadian securities
rdbdq	regie du batiment du quebec
regc	cable regina
ren	reseau equiglobe network
risq-1	reseau  d'informations scientifiques du quebec (risq)
rj-2	raymond james
rmc-6	royal military college of canada
ruv	richter, usher & vineberg
sask-z	saskatchewan telecommunications
saskat-1	saskatchewan education
scc-305	server cloud canada inc
scl-8	softworks consulting ltd.
shokte	shoktek consulting
sidbec	sidbec-dosco (ispat) inc.
a2hos	a2 hosting, inc.
aac-51	airbus air canada
accesc	acces-cible inc.
acl-118	aearo canada ltd
albert-1	service alberta
albert-2	alberta newsprint co.
albert-6	alberta supernet
amsc-1	alberta municipal saftey codes
arende	arendeeco inc.
arrcmcl	advanced radiodata research centre, motorola canada l
as-2147	atbos software inc
asc-58	aktiv software corporation
au-734-z	apex utilities inc.
bankof-7	bank of montreal
bbv	bva buena vista
bc-71	backland communications inc.
bcn	bell canada (nubell)
bellc-4	bell canada
brewer	brewer's retail, inc.
brocku	brock university
bssm-1	bell sygma systems management
busine-26	business world
c3al	canada 3000 airlines limited
canad-112	12393239 canada inc
canad-30	megavelocity inc.
canpa	canpar
carous	carousel ltd.
carton	cartons st-laurent inc
cc-1150	caithness corporation
ccb-6	the corporation of the city of barrie
ccgl	cumberland computer group ltd
ccl-534	centurylink communications, llc
ccml-38	canad corporation of manitoba limited
cdridq	centre de recherche industrielle du quebec (criq)
ce-192	corus entertainment inc
cgtm	cgi gis telecom mdc
chs-11	crofton house school
cidm-1	concepts in data management
cjl-1	college jean-guy leboeuf
cmec	council of ministers of education, canada
cnb-1	city of north bay
cnb-4	connect nb branche inc.
cobou	cobourg networks inc.
colleg-6	college recruiters
coopt	cooptel coop de telecommunication
cosset	cossette communication inc.
cp-407	the centos project
crs-149	charles river systems, inc.
css-199	commission scolaire des samares
ctg-110	town of georgina
cudsb	college universitaire de saint boniface
cvcl	nicolanet
cwa	c. w. agencies
cygna-1	cygnal technologies
dc-81	dan crampton
devryi	devry inc.
dfc-32	digital fortress corporation
dgl-85	devry greenhouses
dhdm	d. hodgins data management inc.
djt-2	digitally justified technology inc.
dsbn	district school board of niagara
eh-236	edgar highspeed inc.
elco	elecomm interlink corporation
encan-1	encana corporation
eno-1	educational network of ontario
enviro-5	envirovision 2010
epicga-1	epic games inc.
ergone	ergonet marketing
essfu	simon fraser university - external services
exhib-3	exhibition place
fbcs	f.m. business computing services
fbsl-1	forbes broadcast services, ltd.
fc-1486	fraxion communications inc
fcsl-1	fundy computer services ltd.
fenwic	fenwicke enterprises
fglte	fgltel inc.
flypt	uberflip
fmw	fairhall, moffatt & wood
fsmm	fido stores (metropolis metrotown)
future-5	future technologies
futuri	futur info inc.
games-204	gameservers.com
games-251	gameservers.com
gba	global business alliance inc.
gcrui-1	gcruise.com
genat	genatec, inc.
gisu	geoff's inter-networking solutuions unlimited
googl-1	google llc
gwnsl	g.p.n. wireless network solutions ltd.
hdeltd	hde ltd.
hennin	henning associates
hhes-1	hamilton hydro electric system
hp-29	host papa
hs-506	hosted sfy
huskyo	husky oil
hw	harewaves wireless inc
ibc-3	insurance bureau of canada
ibc-67	insurance bureau of canada
idc-60	industrial digital corp
intac-2	intact financial corporation
integ-214	integral group inc
intern-113	internet microtec
intern-207	internode networks
intern-85	internet trois-rivieres
iosco	iosco
ipml	island paper mills ltd.
iss-5	interlinx support services, inc.
jrh-1	hay-net networks
kanate	kanatek technologies, inc.
kibble	kibble prentice
krame	kramer mazda
latis1	latisys-ashburn, llc
lei-1	local environmental initiatives inc.
lg-180	logan gateway
lgi	linnet graphics international inc.
lgmw	lions gate media works
li-374	lixar
linnet	linnet geomatics
linqco	linq communications
linx	bell canada
liqui-24	liquidnet ltd.
lisi-1	library information services - ism
ln-108	lanka nap
lonetc	lonet communications
mac-2	mining association of canada
mcl-1697	mobile communications, llc
mcs-129	maxim computer system
met-3	mobius encryption technologies
mh-944	machost.co
mig-1	multiple images group inc.
mindg	mindgeek-la
mirwe-2	mirweb solutions
mj-99	mcmaster technical services
mlcel	memory lane computers electronics ltd.
mmc-17	mixed metaphor cafe
mnp-34	market news publishing inc.
mocte-1	moctel
mpi-10	manitoba public insurance
mrnet-1	mrnet
mtss	muschett technical servicesnetwork services
nas-109	naylor association solutions
ncaat	niagara college of applied arts and technology
ncaat-2	northern college of applied arts & technology
news-1	news
novas-7	simplycast interactive marketing ltd.
oasist	oasis technology
obock	obock
oh-111	orthotic holdings
oh-140-z	the ottawa hospital
ol-17	wavedirect telecommunications
ol-202	onewisp
ol-370	ohanacraft, llc
ol-89	objectif lune inc.
olc	ontario lottery corp.
olei	onion lake ecdev isp
omniwe	omniwest solutions inc.
omw	odgen murphy wallace
ontar-34	coextro
openf-1	openface internet
orn	ontario research network
paulpe	paul pereira
pcn-7	pacific cost net inc.
pcswir	pcs wireless, inc.
pgpl	prince george public library
pi-346	pulsar informatique inc.
pifii	2pifi, inc
posit-7	positive e solutions inc.
pr-30	paliare roland
praxai-1	praxair canada
psl-1	polar symmetry limited
qcc-3	qcc communications corporation
qdcl-2	qualico
qts-9	quality technology services, llc
quadr-40	quadranet, inc
rcl-6-z	reuters canada ltd.
rcp-2	regal capital planners
rdn	regional district of nanaimo
rdst	r d s technologies
reconp	recon pvf inc.
redele	red electronics
resea-7	reseau picanoc.net inc.
rfl-31	rg fiber, llc
rrbds	1-800-got-junk
rru-2	royal roads university
sask2	sask#net regional network
scc-14	sunny chiu consulting
sccl-3	sun country cablevision ltd.
scil-17	sunco communication and installation ltd.
sil-242	shadow internet ltd
silc-10	secure internet llc ca
simonr	simon/ross & associates inc
sinome	sinometrics international
smc-67	standard management corp
snc-1	shop network of canada
snd-2	stargate network design
sni-16	six nations internet
snl-95	spyr network ltd
softmo-2	soft moc
sportm	sport maska, inc.
ssd-120	ssq, societe d'assurance-vie inc.
ssl-227	skytrac systems ltd
ssn-2	stop signs for nora
stephe-3	stephen munnings
stm-134	societe de transport de montreal
tcl-6	trw canada ltd
tdb-1	toronto dominion bank
techno-36	technologies optim inc
teloi-2	adaptiv networks inc.
thecit-3	the city of edmonton
thewoo-1	the woodbridge group
tss-5	tsc software services
tssl-35	total server solutions llc
tt-802	traverse telecom inc.
univer-183	university of victoria
univer-279	university of guelph
univer-50	university of alberta
vcc-9	view call canada
vds-2	ville de sherbrooke
verac-1	veracity communications
versat-1	versaterm systems
vexxh	vexxhost, inc.
vhb-6	vanasse hangen brustlin, inc.
videow	videoway
vserve	vservers, inc.
vsl	votek systems ltd.
vsl-5	virtual servers, llc
wat-3	west africa technologies
wdie	wedix
wdn-8	wednet
wel	western explosives ltd.
weldc-1	weldco beales
wfi-24	releasepoint
wtcw	woodbine truck centre wcl
aabcl	abc allen business communications ltd
aaecd	alberta advanced education & career development
aanls	alis at nassau library system
abltd-1	hostedincanada.com
acl-173	axia connect limited
adg-3	architects design group inc.
aesl-56	act equipment sales ltd
ah-54	astute hosting inc.
alber-69	alberta health services
albert-8	alberta health
algoma-1	algoma experts
aloja	alojandoargentina
aml-200-z	agf management limited
arioh	ario hosts
aw-392	avetria wireless
awinte	a&w internet inc.
bandw-406	bandcon
bc-70	backland communications inc.
bceinc	bce inc.
bcte	bctac engineering
bella-22	bell aliant / dial
blink-3	blink communications/ branddimesnions inc
bluti	blutique
bna-34	bell nexxia (asf)
brand-47	brandimensions inc.
brl-4	bc rail ltd.
broad-85	broad-connect telecom inc.
bussi	bussiness objects
ca-1519	cegep andre-laurendeau
cad-2	cable axion digitel inc.
canad-100	entirelydigital
canad-109	cargo telecom
carti-1	cologlobal
cbi-25	computer and business integrators inc.
cc-6	corridor communications, inc.
ccns-11	chebucto community net society
cdwv	corporation of district of west vancouver
cecre	cecrevier
ceesg	callnet enterprises - engineering services group
ceiss	ceiss
cfl-2	csp foods ltd
cikte	cik telecom inc
cil-214	celestica international lp
ciph	cipherkey exchange corp.
cityo-53	city of brampton
ciw-1	caught in the web
cloud-43	cloudwifi
cloud-69	cloudvpn inc.
clsm	colosseum online, inc.
cnc-2	college of new caledonia
conne-44	connexon telecom
copern-4	copernic technologies inc
crcsd-1	cedar rapids community school district
crdh	capital regional district health
cslsl	csra state and local solutions llc
ctc-11	canadian tire corporation, ltd
cucm-1	credit union central of manitoba
cwe-34	commander warehosue equipment
cyber-23	cybernet communications inc.
dals	dynix automated library systems inc.
del	develcon electronics ltd.
dfait-1	dept. foreign affairs and international trade
dfd	digital fix development
dhdat	dh datacentres inc.
digita-7	digital science inc.
doubl-24	double f & company ltd
dtc-4	the desktop training centre
earthp	earthprobe, inc.
ecomin	e-com inc
equist	equist, inc.
ericss-1	ericsson communications inc.
escl	electrozad supply co. ltd.
etc-4	expert technology corporation
ews-31	epidrive webhosting solutions
fcc-2	farm credit canada
fcs-3	fundy computer services
fdcse-20	fdcservers.net
fhm	foodservice and hospitality magazine
fqcl	franklin quest canada, ltd.
frcn	free range cloud netherlands
gatema	gateman-milloy inc.
gdt-3	galleon distributed techonologies
git-20	iweb technologies inc.
govtof	govt. of canada
granda	grand associates
group-42	groupe van houtte
gsgl	genii solution group ltd.
gvc-1	garden valley collegiate
hayesd	hayes dana inc
health-8	healthvision corporation
hollan-1	holland college
hookc-1	hook communications inc.
hrcc-1	hamilton regional cancer centre
hudso	hudson's bay company
humber-1	humber college
hvc-3	hivelocity, inc.
hydro-9	hydro one inc.
ideale-2	ideal ennovations, inc.
inetl	i-net link wireless
infora-1	inforamp inc.
inform-38	information london
ins-37	interhop networking services inc
intui-73	intuit inc.
invesc-1-z	invesco group services, inc.
ioca	internex online inc.
ippdm	institut philippe pinel de montreal
irist	iristel inc
iwaret	iware technology inc.
jansse	janssen pharmaceuticals, inc.
jcii	jc international inc.
kaloo	kaloom
khp	kids help phone
krax	korax inc.
kt-439	keepit a/s
laidla	laidlaw inc.
lcdvmdq	la commission des valeurs mobilieres du quebec
lexico-1-z	lexicom ltd.
lgim	le groupe informatique mei inc.
lhsc	london health sciences centre
li-200	laborers international
lis-7	ler information systems inc.
lmsoft	lmsoft
lrfc	lakehead regional family center
lrsd-1	louis riel school division
ma-306	crocweb
mcaat	mohawk college of applied arts and technology
mcclel	mcclelland and stewart
mce	media cannibals ent. inc.
mckins	mckinsey & company, inc.
mcul-5	meridian credit union limited
mdbdm	musee des beaux-arts de montreal
menta-2	mental health centre penetanguishene
mentor-1	mentor training
met-1	government of manitoba
metac-5	meta centre
mhc-10	medicine hat college
micfo-4	micfo-ca
mitsub-9	mitsubishi canada
msft	microsoft corporation
nbccc	new brunswick community colleges - committee
nblc	anbl
ne-226	norstar enterprises inc
neptun-9	neptune internet
netpo-1	netportation llc
nins-1	allcore communications inc.
nlic	noble lion investments corp.
nnsg	nsg network software group, inc.
ns-348	nmedia solutions inc
nsc-11	north star communications
ntg-22	sable voice services inc.
ntl-101	nexus technologies, llc
ocls	ocls
ofn-2	ontario first nations
ohino	ottawa-carleton health information network (ochin)
oimul	orbis investment management (u.s.), llc
oisl	ormed information systems ltd
ontin-1	2138617 ont inc.
pdc	paradigm developments corp.
pmt-37	pc mobile tech
pps-110	psav presentation services
proco-15	procom
pwh-6	parcom web hosting
qitx	qitx inc.
qwest-28	qwest corporation
ravan	ravand cybertech inc.
rbl-1	rice brydone limited
rcc-194	rogers communications canada inc.
recher	recherches miranda inc.
rigst-1	rigstar communications inc.
rural-20	rurallynx inc
rw-27	rionet wireless inc.
sac-4	st. andrew's college
sask	saskatchewan telecommunications
savpl	savplus inc.
schola	scholars.com
scl-16	shell canada ltd.
scma	shumka craig & moore adjusters
scu-3	steinbach credit union
sd-5	single digits, inc.
seasi-12	seaside communications, inc.
shawc	shaw communications inc.
sklent	skl enterprises
sm-1015	server mania inc
sm-1015	server mania inc
socomt-1	socom technologies inc.
solcor	solcorp
sounds	xunil corporation
ssoc	shl systemhouse/ottawa outsourcing centre
staple	staples, inc
stc-8	software technology center
swcb	saskatchewan workers compensation board
tatac-30	tata communications
tc-2230	txio corporation
tdc-34	toronto datacomm & cables inc.
tdc-70	triton digital
teleco-4	telecom canada
theint-4	the internet companion
to-16	think on, inc.
tol-10	telecom ottawa limited
tpn-22	terago ptp networks inc.
trans-548	transcontinental plm inc
trave-26	travel superstore inc
tss-9	thornhill secondary school
ttc-44	taylor telephone cooperative, inc.
twc-5	time warner canada
txbase	txbase systems inc.
unnoi	unno
upei-z	university of prince edward island
urbn	urban communications, inc.
vanier	vanier college
vcc-52	vancouver community college
vces	visisolve consulting and educational services
voxil-10	voxility-am
vtlip	videotron telecom ltee
wbm	western business machines
wcrcsb	wellington catholic district school board
wis-5	westech information systems inc.
wisl	whistler networks
worldc	world chat
wsl-121	wt squared llc
wt-86	wtc communications
xplor	xplornet limited
zscal	zscaler, inc.
scs-75	sun computer systems
sde	government of saskatchewan
server-17	serverbeach
sgmlop	sgml open
shlsys-3	shl systemhouse incorporated
sirstjl-1	solar internet repairs sir tech jamaica
skyca-3	fastly
sn-312	spliced networks inc.
sna-8	sony north america
solow	solowave investments
srdmm	sram
ssc-51	sierra systems consultants, inc.
ssg-5	stellar systems group
ssha	ontario health
ssl-208	syntax systems limited
ssung	samsung sdsa us network group
strikm	stikeman elliott
sunny-14	sunnybrook health sciences centre
synops	synopsys inc.
system-19	systemware inc.
takas	takashi umezaki
tcgcl	thomas cook group ( canada ) ltd.
tcs-124	teledata cable systems
techno-40	technologies m4 inc.
tecsys-1	tecsys inc.
telege	telegescom
terraf	terraffirmative
theint-5	the internet centre
themic-1	the micro solution inc.
thepro-8	the proteus group
thunde-9	thundertel llc
tinet-1	tinet
tisl-3	tyco integrated security llc
toron-2	toronto internet exchange community
trby	tera-byte dot com inc.
trentu-z	trent university
trm-13	total resource managment, inc
trsi	trsi
tssl-13	total server solutions l.l.c.
ttc-3	tjs training centers
twt-8	tranzeo wireless technologies
univer-122	university of manitoba
us-375	ubisoft (singapore)
vi-136	voyageur internet inc
virtu-34	virtual solutions
vis-3	varnet information systems inc
wardro	wardrop engineering
wbl-18	wholesale bandwidth ltd.
wcl-4	the woodbridge company limited
wem-1	original wempi, inc.
wis-2	wimsey information service
wl-718	wirecat llc
wlc-12	wood lake cable
wrs-7-z	wind river systems, inc.
yrdsb	york region district school board
4ml	4119909 manitoba ltd
aaisl	ais advanced information systems ltd.
aasll	asl analytical service laboratories ltd.
ael-356	ae hosting
aires-862	airespring, inc.
akamai-6	akamai
amana-1	amanah tech inc.
an-327	accedian networks inc.
arenac	arena communications
azoog	azoogle ads inc
bayco-3	bayconet, inc.
bbc-8	bethany bible college
bcsl	bowest computer systems ltd.
bdlh	bruce de leenheer holdings
bellca-1	bell canada
bgnlc	northern lakes college
bil-64	bigbox infosoft llp
biowar	bioware corp.
bombar-6	bombardier incorporated
brck	brickworks communications inc.
btame-128	bt americas
btd-19	braveway toronto dc
busin-6	businet communications
bws-6	bmm/infotree web solutions
caaque	automobile et touring club du quebec (a.t.c.q.)
cakem-1	cakemail inc.
canac	canaca-com inc.
canad-60	hybrid cloud gateway canada
canad-75	dotto-one inc
canad-87-z	navigata communications limited
canadi-1	canadian marconi company
cas-271	courts administrative service
casd	consortium for administrative systems development
caval-11	cavalia inc
cca-4	canadian centre for architecture
ccai	computer consulting associates international
ccine-6	ccinetwork.ca inc.
ccl-43	wolters kluwer canadian limited
ccs-11	canadian cancer society
cd-808	city of delta
cdcdq	centre des congres de quebec
cdcimg	centre d'acces communautaire internet de mont-louis et gros-morne
celes-3	celestial freight
cenosi	cenosis
cgimed-1	cgi media
cgp-1	the city of grande prairie
champl-4	champlain college
cibcse	cibc securities, inc.
cis-20	cyberstuph internet services
citt-1	canadian international trade tribunal
cityof-83	city of surrey
cjl	college jean-guy leboeuf inc.
cl-1167	copyseis ltd.
cme-2	communications multimedia enter-net
cnc-132	comm100
cnti	citenet telecom inc.
cois	cyberspace online information systems
comdev	com dev ltd.
compug-2	compugen systems
comspe	comspec communications
cosl-2	continuum online services ltd.
cprosts	center for policy research on science and technology (sfu)
crdsab	centre regional des services aux bibliotheques
csacdv	commission scolaire au coeur des vallees
css-294	coop de solidarite du suroit-csur
cw-727	cloud wiz inc
cwm-12	cibc world markets
davgro	davgro corporation
dawson	dawson college
dcs-5	debug computer services
deale-18	dealertrack, inc.
demons	demon systems
dems-5	direct energy - managed sharepoint 2007
discov-41	discovery solutions
dm-357	optionsdsl
dmn-2	digital media networks inc.
dpl-126	digital products limited
drias-2	driasi inc
edc-6	everyware development corp.
edtel	ed tel
egsc-3	the exchange global server center
eicont	eicon technology
ekkum	ekkum inc
electr-5	electro sonic inc.
equant-1	orange business services u.s., inc.
es-1148	ehealth saskatchewan
eslac	dxc us latin america corporation
exfoi	exfo inc.
fl-527	fiber logic inc.
frf-27	fbw reseaux fibres inc.
gcaat-2	georgian college of applied arts and technology
giroen-z	giro enterprises inc.
gpfsmdg	groupe promutuel
gridli	gridlink
gsc-58	government of saskatchewan communitynet
gtd-14	groupe technologies desjardins inc.
hibite	hibitek
hr-63	harris rebar
hrps-1	halton regional police service
hss-116	hostflyte server solutions
hw-23	hybrid wireless inc
idc-103	i.c.e datacenters
imetr	imetrik global inc
indi-1	integrated network of disability information and
inform-43	informatique publiweb inc.
inl-46	rock island communications
innsy	innsys incorporated
intel-406	intellihot
intern-18	internet services
jc-744	solufi
jlinte	jl international
knc-9	knowledge network corporation
kochic	kochica communications, inc.
kpc-23	heavy computing
landma-50	landmark homes
lbkinc	lbk inc.
lc-1176	limewave communications inc.
liqui-21	liquidnet ltd.
lnh	hostmysite
lr-218	lion resources, inc
majors	major systems
maplen-1	maplenet technologies inc.
markm-2	mark messcu
mc-3250	m2m communicators inc
mc-647	start communications
mc-733	mailchannels corporation
mdtdq	ministere des transports du quebec
microm-6	micro-matic
misi-1	mallorn information systems innovators
mwhv	reenigne
nabcs	taylor college and seminary
ncaat-1	niagara college of applied arts & technology
ncste-z	ncs technologies
netad-3	netadmins inc
netres-1	net results
nftcl	the north frontenac telephone corporation limited
nirote	niro technologie
nis-76	nexus internet solutions inc
nl-407	netspeed llc
nnc-5	nebulus network control
nncl-1	nor net communications ltd
nobel-59	nobeltel llc
npiec	niagara peninsula industry education council
nslaad	nirve sports ltd. attn: accounting dept
nsms	north saanich middle school
nwsd	new westminster school district
object-3	objective edge, inc.
oconn-12	oconnor associates
oh-207	oath holdings inc.
ont-1	ontario northland telecom
ops-60	oshawa puc services inc
optimi-1	optimisation-bureautique inc.
pc-2082	pangeo corp
peo-1	professional engineers of ontario
periph-1	peripheral express inc.
phlcnbl	plant hope laurence claims new brunswick ltd.
pibscf	peer1 internet bandwidth & server co-location facilities
picc-1	prudential insurance company of canada
pmtvid	pmt video inc.
potl	pro omnis telecommunication ltd.
presci	prescient international, inc.
psic	psinet ltd. (canada)
pt-397	pureflow technologies
quadra-4	quadravision communications, inc
rc-700	rotary corporation
rcl-7	r.a.parson consulting ltd.
rgdcom	rgd communications inc.
rkn	koumbit
rpc-6	reform party of canada
sacat	saca technologies, inc.
sasken	saskenergy inc.
scinet	scinet communications
scompi	scompitech inc.
scotta-2	scott & aylen
scs-14	spydernet communications systems inc.
scti	strathcona career training institute
sd4	school district #42
sd5	school district 57
senton	senton printing
silico-6	silicon systems, inc.
softgu	softguard inc.
softwa-49	software metrics inc.
sol-27	hostroyale llc
spectr-8	spectranet
speed-70	speedyrails
spxhs	st. pius x high school
srcl	smoky river coal, ltd.
stu-1	st. thomas university
subsc-4	subscribercentral canada inc.
swd-26	swd
tbay	tbaytel
teliz	telizon inc.
terrap	terraport online inc.
theele	the electric mail company
thesta-12	the starbright foundation
thp-14	trillium health partners
times-2	timesway network
tmsmar	tms marketing inc.
tnc-51	technology north corporation
total-65	totalconnect telephone company
udm-10	universite de moncton
udqm-1	universite du quebec a montreal
vec-49	vsnl enterprise colo
vhgs	virtual hosting group servers
vho-1	virgin home ontario
vvit	v.i.t. voyages intair transit inc.
wanted-2	wanted technologies
wavesp-1	wavesplitter/applied fiber
wic-37	west ip communications
wlnlia	webnet - lunetterie new look internationale (anjou)
wowtec-1	wowrack.com
wright	wright's r&d
wsl-9	white spot ltd.
wwtc	working world training centre
zc-80	buzzmax.ca
zoici	zoic studios
365294	365294 alberta incorporated
3cio2	3757277 canada inc. (oa 295.ca)
acl-103	rackco.com
act-5	alliance commerciale technologique
adobes-z	adobe systems inc.
ag-488	arris group, inc
aim	ashnola internet management inc.
al-770	yyc net lab
albedo	albedo net
alcul	air link networks
alkogr	alko graphics
anders-6	andersen consulting
applec-1-z	apple inc.
arctu-1	arcturus networks inc.
ascl-1	alcan smelters and chemicals ltd.
atsi-21	acuity technology solutions in
awc-2	alec wilson coldstream
axones	axones telecommunications inc.
aztecc	aztec computer inc.
bc	bcnet
bcawhis	bell canada atlantic wireless home internet service
bds-8	blackwood data system inc.
bestse	bestseller inc.
bi-117	behaviour interactive inc.
bia-2	bac inc. (anx)
bibli-3	bibliocommons inc tor2-04-4.3/08.4.2(1) (get number)
big-4	buzz image groupe inc.
binary-5	binary ink incorporated
blon	672615 b.c. ltd (o/a netaholic
bmd-1	bare metal designs
bpc-7	birchmount park collegiate
bpl-13	brampton public library
bt-199	belair technologies
c1f	cibl 101.5 fm
cblv	cablevision du nord de quebec inc.
cc-10	commstream communications inc
cc-1288	canhui chen
cc-928	cloud a
ccl-38	ciba canada limited
ccs-199	caledon card services
cdddq	centre de detention de quebec
cdredp	conference des recteurs et des principaux
cellot	cellotape inc.
centre-1	centre entreprendre
cgi-22	cgi
cheo	children's hospital of eastern ontario
chill-2	chill communications
chrish	chris hawley
ciabe	cinemanow, inc. attention bruce eisen
cibc-1	canadian imperial bank of commerce
ciml-1	continental insurance management ltd.
circoc	circo craft inc.
cjcc-2	canadian jewish congress (cjc)
cl-1277	cloudroute, llc
cn-140	carbon60 networks, inc
commun-96	communication telosysteme inc.
compu-208	computogram inc.
compus-1	compusense, inc.
connec-52	connectability inc.
consys	con-syst-int engineering
cormar	cormark communications inc.
courde	courdeau-procinbec inc.
cpc	canada post corp.
cpol	creative people on line
cpuser	cpu service d'ordinateur inc.
cspr	caspar computer services inc.
ct-931	centurylink technology
cummin	cummins engine co.
cwb-4	canadian wheat board
dc-835	dnsnetworks corporation
dcwa	d c wilson associates
del-37	digital extremes ltd
dimona	dimona aircraft co.
distri-1	distribution parent
dreaml	dreamlan network consulting ltd.
dto-1	data tech online
dunnyi	dunny inc.
edo	export development organization
egat	e-gate communications inc.
eidq	eller industries, dba qenex
emsb	english montreal school board
expres	express scripts incorporated
faltec	faltec inc.
famici	famic inc
faxfx	fax/fx
fdcse-8	fdcservers.net
finsec	finsec services inc.
fiq	formation internet quebec inc.
frl-1	feed rite ltd.
fttcne	fttcnet canada
fwcu	first west credit union
galax-15	galaxy multimedia corp
gatesc	gates canada inc
ges-8	gas equipment supplies
glel	glenayre electronics ltd.
globa-311	globalive wireless management corp. engineering department
gover-8	government of saskatchewan
gtn	global television network
gws-84	gervais web solutions inc.
hcc-6	hardware canada computing
hho	hps, head office
hnl-76	hfl networks llc
honda-3	honda canada inc.
hsc-180	heymman servers corporation
icaxon	i.c. axon
icgrou	ic group
idta	institut de technologie agro-alimentaire
iisd-2	iisd
inter-121	interface technologies, inc.
intera-71	interact multimedia, inc.
interc-11	interconnet
intern-34	internet canada incorporated
intern-40	internet montreal
ips-6	internet portal service
is-369	internet security
isn-1	island services network
isotr-1	isotropic networks, inc.
itncor	itn corporation
itrac	itracmedia inc.
ki-254	knox industries inc
krfscl	kaufman rossin fund services (cayman), ltd
kt-24	kal tire
ldpa	l'union des producteurs agricoles
legend-8	legend corp
leitch	leitch technology inc.
lg-28	lg2
lh-138	lunanode hosting inc.
liber-130	161 liberty dynamic customers
lovejo-2	lovejoy canada
manito-1	manitoba hydro
mau	mount allison university
mbc-171	manitoba blue cross
mcfs	metro calgary fiber services inc.
mchso	mch solutions
mcm-2	mulvihill capital management inc.
medidi	medi-direct inc.
mgr	mercantile and general reinsurance company
ml-579	fastnet communications
mlsl-8	micro logic
mp-919	mcneil printing
mpvwi	mpvwifi inc
mun-4	memorial university of newfoundland
ncol	north canadian oils ltd.
netac-4	netactuate, inc
netcr	netcrawled
netwi-7	netwire inc
northl-13	northland engineering
northw-29	northwestel cable inc.
nouvel	nouveler
nsp-7	nova scotia power incorporated
ntpb-1	network technology professionals (b.c.) inc.
obsidi-2	obsidian corporation
oet	the ontario educational communications authority
ohh	osler, hoskin & harcourt
ontar-9-z	rural wave
ontari-5	ontario hydro
opc-7	ontario prevention clearinghouse
opend-2	cisco opendns, llc
ow-98	omni wireless inc
payme-7	payment processing inc.
pchu	board of health for the peterborough county-city health unit
petcom	petcom industries
pip-1	progi-soft informatique (psi)
pl-962	polygon.io, inc
pmsl-3	pwc management services lp
primat	prima telematic inc
ptcipr1	primus telecommunications canada inc. -pacific-023- reg 1
ptdqm	parc technologique du quebec metropoliatan
puc-2	cochrane telecom services
quebe-49	navigue.com
quick-30	quickplay media
qv-3	quantalgo ventures, inc.
racks-8	rackspace hosting
reol-1	rice engnring & operating ltd
rfg-2	rice financial group inc.
rim	blackberry limited
rixcl	rixcloud
rl-151	uswhss.com
rsfx	r.m. of st. francois xavier
rsl-1	rogers sugar ltd.
sandri-1	sandrix consulting
sbl-28	shorcan brokers limited
sc-786	second clothing
scn-18	server central network
se-1596	seakr engineering, inc.
sec-162	spectra energy corporation
serve-128	servermania inc
sia-9	saskatchewan polytechnic
sians	software industry association of nova scotia
sideai-1	sidea inc.
sierr-11	sierra wireless, inc.
sil-69	secure internet llc
silve-13	silverservers inc.
sjpg-1	st. joseph print group inc.
skl	software kinetics ltd.
skl-1	software kinetics limited
source	source fm
speedw-1	fresche solutions inc.
srp-3	st. remy press
sss-23	stellys secondary school
stn-11	swc telesolutions, inc.
sul-28	sw usa llc
system-6	systemetrix corporation
tda-13	team d auto
telep-21	telephone drummond, inc.
terren	terren corporation
theco-16	the county of oxford
thecon-6	the connection bbs
theint-3	the internet conveyor, inc.
thepix	the pixel factory inc.
thesin	the sinai group inc.
thewe-29	the western james bay telecom network
til-47-z	tolko industries ltd.
tm-756	townsquare media inc
tmm-44	triple m metals inc
townsh	township of marathon
trl-41	terrequity royal lepage
tsl-212	3t systems ltd
tts	telecommunications terminal systems
udqr-z	universite du quebec a rimouski
unbsjc	university of new brunswick, saint john campus
unive-192-z	universite de moncton campus d'edmundston
vanta-28	vantagepoint systems inc
vcs-5	vaxxine computer systems inc.
vds-8	babytel inc.
vhl-176	vultr holdings, llc
vmware	vmware, inc.
vsp-1	virgin snow productions
vurge	vurge inc.
wbh-8	whistler blackcomb holdings inc.
werdzc	werdz communications
willi-168	williams-sonoma inc.
wis-103	wisp internet services inc.
wlcl	westcoast lan company ltd.
wml	westar mining ltd.
wpp	western producer publications
wsa-1	wes smith and associates
xcs-2	xenitec consulting services
zulty-2	zultys, inc.
3in	3men@work integrated networks, inc.
aatglp	atg arrow technology group limited partnership
abc	alberta blue cross
ac-1565	appdirect
accel-55	accelerator centre
acl-1149	afn cloud ltd
acl-1400	athena cloud
aclt	accelerated connections inc.
activ-32	activision publishing, inc.
adpsys	adp systems inc.
adria-1	one zero hosting inc.
aetnat	aetna trust co.
afs-8	applied financial systems inc.
ail-1	alcan international ltd.
ainswo	ainsworth technologies
algeri	algeria online
ama-5	alberta motor association
amaron	amaron canada
apog	apogee telecom inc.
apwss	alberta public works, supply and services
as-868	arris solutions, inc.
asimwa	asimware innovations inc.
atc-13	anjura technologies corporation
atria-5	atria networks lp
atsaer-2	ats aerospace inc
bbh-13	bowe bell + howell
bc-383	bonnecomm
bcn-25	broadband communications north inc.
bct-60	black creek tv
bellm-10	bell mobility, inc.
bellm-3	bell mobility inc.
betas-1-z	beta systems software of canda inc.
bl-569	swift internet inc.
bombar-8	bombardier aeronautique
bossco	boss computers
brp-22	brookfield residential propert
bsal	b.a. saville and associates, ltd.
bt-427	britesky technologies inc
btl-93	base wireless
builda	build-a-mold
busin-34	business continuity inc
calpur	calpurnia communications
canad-99	pioneerwireless
canadi-4	canadian bioconcepts
cbn-1	canadian bank note
ccal	cygnus computer associates ltd.
ccdt	telekenex inc
ccgepm	cegep marie-victorin
ccoac	canadian council on animal care
cdl-2	cegep de levis-lauzon
cdmr	district of maple ridge
cegepf	cegep francois-xavier-garneau
centen-3	centennial college
cfl-3	csp foods ltd
cfpl-z	canadian forest products ltd.
cgtxin	cgtx inc.
cibc-8	cibc
cicl	chemetics international company ltd.
circl-14	circle company associates, inc.
cit-7	cableshare interactive technologies inc
cityof-25	city of regina
cityof-37	city of nanaimo
cityof-43	city of toronto
cl-2215	cobaso, llc.
colba	colba net inc.
concor-15	concordia university
conve-17	convergia inc.
correi	correia inc.
cots-1	call one telecommunication services inc
cpi-4	communications & power industries, llc
cronom-1	cronomagic canada inc.
cs-2638	celero
ct-843	canlith technologies inc.
ctl-162	crave technologies ltd.
cul	canadian utilities, ltd.
dcaat-1	durham college of applied arts and technology
dcn	disc computer network
desir-2	desire 2 learn
dgb	dominion group benefits
dis-12	dbcorp information systems inc.
disuc	direct internet systems / unique computer
dmfa	d. m. francis and associates
edmont-1	edmonton power
epikn-2	epik networks, inc.
epsbdn7-z	edmonton public school board
ercbe	energy resources conservation board (ercb)
ericss-15	ericsson canada inc.
eriksd	eriksdale school
ew-156	expeto
facili-1	facilitate i.t. inc.
facr	frontenac-lennox and addington co. rcsb
faneui	faneuil isg inc
filca	100fil.ca
fraser	fraser and beatty
fundyt	fundytek inc.
gc-152	globaltelehost corp.
gcrui	gcruise.com
gdmsc	general dynamics mission systems - canada
gdsc-4	giesecke & devrient systems canada, inc.
gmamur	gma/murata electronics
govi	govital internet inc.
gsc-2-z	green shield canada
haclsd	hughes aircraft of canada ltd., systems division
hbmscl	hudson bay mining and smelting co., limited
hc-648	hmshost corporation
hcpmt	home care program for metropolitan toronto
herita-3	heritage institute
hl-110	hylife ltd
hs-444	hosting services, inc.
hsm-120	high speed mole inc
humber	the humber college institute of technology and advanced learning
ibcl	ina bearing company ltd.
idcgdq	institut des communications graphiques du quebec
iit-64	idigital internet toronto
il-750	i.d. logique
inc-52-z	ice ngx canada inc.
intel-45	intellimarketing corporation
interj-1	interjonction concepts
isls-1	internet saguenay lac st-jean inc.
itera	iteract inc.
jentel	jentel interactive
jre-15	ict canada
kc-35	kilobytes computers inc
kronos	kronos inc.
kuc	the king's university
lansco	lansco inc.
lbs	leppert business systems inc.
lectra-6	lectra systems inc
legro-2	planethoster
leitch-1	leitch technology inc.
lel-15	lakeland networks
lgl-8	lexington group, llc
liqui-16	liquidnet ltd.
lotoqu	loto-quebec
lsm-1	logic systems mccarthy-williams inc.
media-179	media-hosts inc.
memli	memlink
mfl-51	mccain foods limited
mgequ	mg-equinix-pa
microm-15	micromedia, ltd.
mie-15	manitoba internet exchange inc
mmil	mantech micro innovations ltd
molson	molson canada
momen	momentous.ca corporation
montre-2	montreal internet inc
mrp-2	media realms productions inc
msl-3	merlan scientific limited
mvl	master-flo valve, inc.
nanome	nanometrics inc.
ncbe	northumberland and clarington board of education.
netmo-3	netmosphere
networ-15	networking north inc
nidias	nidi associates
nmrg	new media research group
ns-491	netmotion software, inc.
nsaho	nova scotia association of health organizations
nserc-3	natural sciences and engineering research council of canada
obds-1	obds
ordino	ordinox network inc.
oshawa-1	oshawa group
pccb	pepsi cola canada beverages
pcsint-1	pcs internet
peopl-16	people admin
pharma-45	pharmacia inc.
phoeni-93	phoenix management
pixelm-1	pixelmotion images inc.
ppds	pacific press - a division of southam inc.
prisz-4	priszm lp
procor	procor
progre-15	progressive solutions inc.
prp	peel regional police
psl-99	pyr software ltd.
psuc	pason systems usa corp
ptc-10	prodigy technology corporation
ptcieh1	primus telecommunications canada inc. -eastern-006- hmt 1
rca-28	risq canet access
rcc-106	rogers cable communications inc.
rctl	redden cable tv ltd.
rpl-1	regina public library
saes-3	sfu (acs) external services
samcos	samco software inc.
saput	saputo inc
sav-2	sac affaires vl
schs-6	simcoe county health services
abovoc	abovo communications
accent-2	accent internet
aci-37	air communications int
active-2	active systems
aflw	service alberta
agosti	agostinelli consulting
aib-17	akamai international, bv
aic-9	axion internet communiations inc.
ail-4	afg industries ltd.
albert-3	alberta meganet
alcal-1	alcalytics inc
allied-6	allied genius
amana-5	amanah
amci-3	atlantic metro communications ii, inc.
amerco	amer.com
aml-1-z	agf management limited
amtot	amtote international, inc.
apvio	apvio, inc.
artefa	artefact informatique inc.
ats-184	ames tile & stone
atsaer	ats aerospace
aucc	association of universities and colleges of canada
bchydr-z	b.c. hydro
bcit-1	british columbia institute of technology
bcmwhis	bell canada manitoba wireless home internet service
bel-4	binary environments ltd.
bhs	bridgetown high school
bonnec	bonnechere resources
bp-223	bernston porter & co
brando-3	brandon university
bridge-2	bridge network
broadb-31	broadband-collaborative.com
burh	burlington hydro, inc.
cac-89	colocation america corporation
caein-z	cae inc.
callst	callstream communications, inc.
canad-64	gotekky
cansca	canscape inc.
cc-3698	11187929 canada corporation
ccl-242	crystal computers ltd
ccritc	ccrit-communications canada
ccs-58	care computer systems, inc.
cdc-153	c15edge data centers
cdic	canada deposit insurance corporation
cdpubc	cd pubco inc.
cegeps-1	cegep sorel-tracy
cfo-1	consumer finance online!
cgot	cogeco telecom
ci-78	ci investments inc.
cldre-2	cldr.eu
clicne	clicnet telecommunications inc.
commi-4	commission scolaire des phares
conoc-1	conocophillips company
cpa-3	christopher portway & associates, inc.
cpc-411	crown packaging corporation
crcssdn	calgary catholic school district
cross-86	cross country tv ltd
cs-2810	cfm services inc.
csa-72	cs des affluents
csc-28	canadian stroke consortium
csddcdc	conseil scolaire de district catholique du centre
cybers-9	cybersecure inc.
daf-4	government of saskatchewan
destin-14	destiny networks
dll-21	deepcove labs ltd
dml-135	pacy world
drl	dymaxion research ltd.
easte-46	eastern irrigation district
ec-77	evolve communications
eic-28	e. i. catalyst
eil-79	emeigh investments llc
emerg-9	emergis inc.
empowe	empower computerware, inc.
es-1382	entegrus inc.
eten	end to end networks
ets-139	edmonton transit service
fbn-1	financiere banque nationale inc.
fc-1108	fibernetics corporation
fcaa	fanshawe college of applied arts and
fcl-5	fwj communications ltd.
feo	french embassy, ottawa
ffdrdl	frsq (fonds de recherche de la
fleeth	fleet house
fm-62	fute media inc.
fmd-6	fasken martineau dumoulin
fmmo	fmmo publications informatiques, inc.
front-16	frontier networks
fsbc	fujitsu systems business of canada
fsht	four seasons hotel toronto
fusem	mailanyone.net
ga-113	goemans appliances
gamel-2	divertissements gameloft inc
gamman	gamma networking inc.
gcl-9-z	gregory consulting limited
geekh-2	geekhost
gisc-2	globex internet sevices corporation
gpf	great plains free-net inc
greatw-2	great-west life
groupe-3	groupe lgs inc
groupe-5	groupe cerveau
gt-127	group of goldline
henic	henico inc
hhs-66	hallmark housekeeping services
hlc-3	high line corp.
ho-2	ovh hosting, inc.
honeyb	honeybee software inc.
hoste-21	hostedbizz incorporated
hostp-2	host papa, inc.
hostp-7	hostpapa
hs-466	hosting services, inc.
hwsl-27	hiram walker and sons limited
icc-171	itg canada corp.
iecl-2	ihs energy (canada) ltd.
iis-148	infinite it solutions inc.
im-315	infotec manitoba
imprim-2	imprimerie transcontinental inc.
in	itel networks inc
infosh	infoshare online inc
innovu-1	innovus, inc.
inter-280	interweb media
intern-41	internet haute-yamasaka
ips-13	interprovincial pipe and steel co.
ispcha	isp channel
itl	imperial tobacco canada ltd.
itsco-4	its consulting inc.
jazzco	jazz consulting
kamat	kamatera, inc.
kbstec	kbs technologies, inc.
kenna	kenna group inc.
kinax-1	kinaxis inc.
lakehe-2	lakehead university
lbs-1	l.i. business solutions
lcbe	the lambton county board of education
leum	metro richelieu inc.
light262	lightcrest llc
lil	ledcor industries limited
lnh-3	ladysmith nursing home
lss-3	les services serti inc.
marke-107	marketsp_ce
mch-3	montreal children's hospital
mcnet	mcnet
mdssc-z	mds sciex
mibcin	mibc inc.
micros-43	microsolutions consulting inc.
microw	microworks
middl-9	middlesex county
mig-4	magnet internet gateway
misl-11	mecca internet solutions ltd.
montra	montraeal internet inc.
montre	montreal exchange
montre-1	montreal exchange
mrfnp	ministere de l'energie et des ressources naturelles, gouvernement du quebec
msi-7	mgl systems internet
mtl-1	mpr teltech ltd.
netlin-4	netlink technologies
netwo-107	network innovations, inc.
nntl	neural net trading ltd.
novat	novatel inc.
nsc-114	north stream communications
nscad	nova scotia collage of art and design
ntax	net axis
nutatt	nutat technologies inc.
nwsl	nowsco well service ltd.
oahpp	ontario agency for health protection and promotion
oapl-2	ovh australia pty ltd
ohyd	hydro one telecom, inc.
oiiq	oiiq
ol-34	2267921 ontario ltd
ontar-13	about communications
orcas	orcas sound llc
os-5	oriso solutions inc.
peo-2	proffessional engineers ontario
pgpl-2	pulsus group inc.
pnc-3	power net corporation
psac	public service alliance of canada
psc-9	promis systems corporation
psquar	p-squared consulting
rampar	rampart partitions inc.
rcl-9	rowe communications ltd.
rdaug	red deer apple users group
rebel-4	rebelnetworks inc.
riq	reseau internet quebec
rm-103	rogers media inc.
rti-42	right tech internet inc
sbhn	st. boniface hospital network
schola-2	scholastic inc.
scotia	scotia mcleod inc.
sderm	saskatchewan department of environment and resource management
secur-149	sbk telecom
sense-3	sensei inc.
sequi-2	sequiter inc.
servac	servacom america incorporated
sgi-1	sgi
sgl	sherritt gordon limited
sgl-90	supreme group lp
sicoin	sico inc.
sil-1	stream-flo industries, ltd.
simbra	simbra inc.
sis-304	sis consulting
slc	sun life assurance company of canada
socomt	socom technologies inc.
src-6-z	saskatchewan research council
sss-13	sask. social services
sstn	stn smart talk network
standa-11	the standard life assurance company of canada
tc-1557	tnext communication inc
tdni	transport data network international
theedm	the edmonton telephone company
tipl-8	telecom intellectual property limited
tlc	transamerica life companies
tns-93	tech north solutions inc
topuno	topuno
townof-2	the corporation of the city of markham
townof-4	town of atikokan
tribul	tribu:lintas
tru-6	thompson rivers university
ts-7	telephone de st-ephrem inc.
tssl-12	total server solutions l.l.c.
tu-212	telogiks ulc
tucdc	trans union of canada, inc.
ubitre	ubitrex corporation
ugl-2	union gas ltd.
utlcan	utl canada
valley	valleyteq inc.
varia-12	variantyx inc.
vg-29	volaris group inc.
voxxco	voxx communications
vt-168	voicenetpulse telecom inc
wdje	wm. de jong enterprises inc.
wl-140	wilsonart llc
wmi-16	the wawanesa mutual insurance company
wos	worldchat online services
wpl-1	ward press limited.
www	world wide wave inc.
xtg-1	xns technology group inc.
sg-713	stephane graber, sole proprietorship
sgc-142	solid general contractors inc
sieme-24	siemens enterprise communicati
sii-16	shred it international inc.
sil-4	sharecom industries ltd.
silone	silonex inc.
sis-164	securenet information services inc.
sjhc	st. joseph's health centre
slc-3	st. lawrence college
slmsof	slm software inc.
snl-121	simeon networks llc
softl-6	softline technology
softsm	softsmith systems inc.
softwe-1	secured network solutions
solut-8	sherweb inc.
speed-49	speedyrails
spp-110	sugarloaf provincial park
stockg-1	stockgroup.com
sumo	sumo
tbayt	tbaytel
te-382	transgroup express inc
tec-255	tinyemail
tec-63	technology evaluation center
teliu	teliuvo, inc.
theadv	the advantedge corporation
theoss-2	theos software
thepro-2	the profit centre
tmanc	the toronto municipal area networking co-operative
uds-1	universite de sherbrooke
uhsc	manitoba blue cross
vc-563	voicenetpulse telecom inc.
vcl-16	veco canada ltd
viu	vancouver island university
vvc	virtek vision corporation
waynet	wayne tilley
wcb-11	workers compensation board
we-470	wicked eh incorporated
westco-1	westcoast energy inc.
wsdn1	the winnipeg school division no. 1
xplor-2	xplornet limited
xtc-5	xbase technologies corp.
youngm	young monkey
zenla-7	zenlayer inc
zti	zim technologies international inc.
